episode,utilization,invalid_learned,invalid_attempted,boxes_attempted,placed_boxes,max_height,avg_height
1,0.785,3,0,21,18,10.0,7.85
2,0.744,4,0,31,27,10.0,7.44
3,0.774,6,0,30,24,10.0,7.74
4,0.786,5,0,27,22,10.0,7.86
5,0.76,3,0,24,21,10.0,7.6
6,0.754,5,0,30,25,10.0,7.54
7,0.741,4,0,23,19,10.0,7.41
8,0.74,3,0,22,19,10.0,7.4
9,0.74,3,0,18,15,10.0,7.4
10,0.732,7,0,37,30,10.0,7.32
11,0.858,3,0,28,25,10.0,8.58
12,0.83,3,0,13,10,10.0,8.3
13,0.685,7,0,21,14,10.0,6.85
14,0.84,4,0,28,24,10.0,8.4
15,0.687,9,0,32,23,10.0,6.87
16,0.708,5,0,27,22,10.0,7.08
17,0.75,3,0,25,22,10.0,7.5
18,0.745,6,0,27,21,10.0,7.45
19,0.8,4,0,35,31,10.0,8.0
20,0.765,4,0,25,21,10.0,7.65
21,0.84,2,0,18,16,10.0,8.4
22,0.635,7,0,28,21,10.0,6.35
23,0.78,5,0,31,26,10.0,7.8
24,0.729,5,0,25,20,10.0,7.29
25,0.81,3,0,22,19,10.0,8.1
26,0.65,5,0,21,16,10.0,6.5
27,0.8,2,0,16,14,10.0,8.0
28,0.712,4,0,28,24,10.0,7.12
29,0.74,3,0,28,25,10.0,7.4
30,0.72,7,0,23,16,10.0,7.2
31,0.8,3,0,28,25,10.0,8.0
32,0.76,5,0,30,25,10.0,7.6
33,0.74,3,0,18,15,10.0,7.4
34,0.744,6,0,27,21,10.0,7.44
35,0.732,5,0,23,18,10.0,7.32
36,0.844,4,0,28,24,10.0,8.44
37,0.736,6,0,33,27,10.0,7.36
38,0.64,7,0,27,20,10.0,6.4
39,0.724,4,0,21,17,10.0,7.24
40,0.79,3,0,23,20,10.0,7.9
41,0.754,5,0,21,16,10.0,7.54
42,0.655,7,0,27,20,10.0,6.55
43,0.745,3,0,21,18,10.0,7.45
44,0.772,5,0,31,26,10.0,7.72
45,0.74,3,0,27,24,10.0,7.4
46,0.692,6,0,32,26,10.0,6.92
47,0.776,4,0,25,21,10.0,7.76
48,0.748,5,0,32,27,10.0,7.48
49,0.78,3,0,19,16,10.0,7.8
50,0.704,8,0,34,26,10.0,7.04
51,0.684,5,0,27,22,10.0,6.84
52,0.708,6,0,27,21,10.0,7.08
53,0.79,3,0,23,20,10.0,7.9
54,0.802,4,0,24,20,10.0,8.02
55,0.75,4,0,26,22,10.0,7.5
56,0.725,3,0,25,22,10.0,7.25
57,0.8,3,0,22,19,10.0,8.0
58,0.648,7,0,26,19,10.0,6.48
59,0.81,5,0,33,28,10.0,8.1
60,0.68,5,0,20,15,10.0,6.8
61,0.72,4,0,25,21,10.0,7.2
62,0.81,3,0,25,22,10.0,8.1
63,0.672,5,0,22,17,10.0,6.72
64,0.69,4,0,17,13,10.0,6.9
65,0.676,6,0,27,21,10.0,6.76
66,0.745,4,0,18,14,10.0,7.45
67,0.76,6,0,23,17,10.0,7.6
68,0.752,5,0,27,22,10.0,7.52
69,0.735,4,0,18,14,10.0,7.35
70,0.88,3,0,27,24,10.0,8.8
71,0.735,6,0,28,22,10.0,7.35
72,0.872,2,0,26,24,10.0,8.72
73,0.74,6,0,26,20,10.0,7.4
74,0.76,4,0,23,19,10.0,7.6
75,0.78,3,0,17,14,10.0,7.8
76,0.716,4,0,28,24,10.0,7.16
77,0.72,4,0,19,15,10.0,7.2
78,0.705,4,0,22,18,10.0,7.05
79,0.76,6,0,38,32,10.0,7.6
80,0.744,4,0,27,23,10.0,7.44
81,0.8,3,0,19,16,10.0,8.0
82,0.668,6,0,21,15,10.0,6.68
83,0.85,3,0,28,25,10.0,8.5
84,0.712,7,0,27,20,10.0,7.12
85,0.784,5,0,26,21,10.0,7.84
86,0.642,8,0,27,19,10.0,6.42
87,0.875,1,0,15,14,10.0,8.75
88,0.744,5,0,28,23,10.0,7.44
89,0.84,4,0,28,24,10.0,8.4
90,0.65,4,0,16,12,10.0,6.5
91,0.764,4,0,29,25,10.0,7.64
92,0.746,7,0,26,19,10.0,7.46
93,0.72,7,0,32,25,10.0,7.2
94,0.725,7,0,37,30,10.0,7.25
95,0.76,5,0,27,22,10.0,7.6
96,0.715,3,0,15,12,10.0,7.15
97,0.816,4,0,25,21,10.0,8.16
98,0.824,3,0,23,20,10.0,8.24
99,0.812,5,0,34,29,10.0,8.12
100,0.556,8,0,21,13,10.0,5.56
101,0.68,6,0,28,22,10.0,6.8
102,0.8,5,0,33,28,10.0,8.0
103,0.796,7,0,45,38,10.0,7.96
104,0.787,4,0,23,19,10.0,7.87
105,0.79,6,0,31,25,10.0,7.9
106,0.694,7,0,39,32,10.0,6.94
107,0.592,5,0,24,19,10.0,5.92
108,0.76,4,0,26,22,10.0,7.6
109,0.786,4,0,23,19,10.0,7.86
110,0.841,5,0,22,17,10.0,8.41
111,0.856,4,0,31,27,10.0,8.56
112,0.8,5,0,29,24,10.0,8.0
113,0.669,6,0,25,19,10.0,6.69
114,0.732,8,0,34,26,10.0,7.32
115,0.73,8,0,32,24,10.0,7.3
116,0.896,4,0,27,23,10.0,8.96
117,0.7,3,0,19,16,10.0,7.0
118,0.812,5,0,25,20,10.0,8.12
119,0.816,4,0,26,22,10.0,8.16
120,0.744,4,0,25,21,10.0,7.44
121,0.712,5,0,23,18,10.0,7.12
122,0.78,5,0,30,25,10.0,7.8
123,0.84,2,0,28,26,10.0,8.4
124,0.73,4,0,22,18,10.0,7.3
125,0.712,5,0,27,22,10.0,7.12
126,0.732,8,0,29,21,10.0,7.32
127,0.796,3,0,20,17,10.0,7.96
128,0.85,3,0,26,23,10.0,8.5
129,0.768,4,0,25,21,10.0,7.68
130,0.708,6,0,27,21,10.0,7.08
131,0.66,5,0,18,13,10.0,6.6
132,0.748,6,0,32,26,10.0,7.48
133,0.75,3,0,17,14,10.0,7.5
134,0.804,4,0,35,31,10.0,8.04
135,0.704,6,0,26,20,10.0,7.04
136,0.806,5,0,33,28,10.0,8.06
137,0.78,3,0,17,14,10.0,7.8
138,0.768,5,0,33,28,10.0,7.68
139,0.758,4,0,27,23,10.0,7.58
140,0.75,3,0,19,16,10.0,7.5
141,0.738,5,0,26,21,10.0,7.38
142,0.76,4,0,26,22,10.0,7.6
143,0.77,10,0,45,35,10.0,7.7
144,0.692,6,0,28,22,10.0,6.92
145,0.66,4,0,18,14,10.0,6.6
146,0.786,6,0,24,18,10.0,7.86
147,0.832,3,0,23,20,10.0,8.32
148,0.828,5,0,30,25,10.0,8.28
149,0.792,4,0,29,25,10.0,7.92
150,0.693,8,0,32,24,10.0,6.93
151,0.778,5,0,29,24,10.0,7.78
152,0.63,4,0,17,13,10.0,6.3
153,0.75,3,0,29,26,10.0,7.5
154,0.92,1,0,18,17,10.0,9.2
155,0.763,4,0,32,28,10.0,7.63
156,0.8,3,0,16,13,10.0,8.0
157,0.7,5,0,27,22,10.0,7.0
158,0.713,4,0,24,20,10.0,7.13
159,0.768,4,0,25,21,10.0,7.68
160,0.76,5,0,22,17,10.0,7.6
161,0.68,4,0,19,15,10.0,6.8
162,0.814,3,0,25,22,10.0,8.14
163,0.721,7,0,29,22,10.0,7.21
164,0.832,4,0,27,23,10.0,8.32
165,0.766,5,0,23,18,10.0,7.66
166,0.795,3,0,21,18,10.0,7.95
167,0.794,5,0,27,22,10.0,7.94
168,0.772,4,0,23,19,10.0,7.72
169,0.712,8,0,27,19,10.0,7.12
170,0.805,4,0,23,19,10.0,8.05
171,0.765,3,0,17,14,10.0,7.65
172,0.73,5,0,22,17,10.0,7.3
173,0.886,2,0,32,30,10.0,8.86
174,0.764,6,0,28,22,10.0,7.64
175,0.662,7,0,27,20,10.0,6.62
176,0.75,3,0,20,17,10.0,7.5
177,0.761,4,0,24,20,10.0,7.61
178,0.704,6,0,26,20,10.0,7.04
179,0.744,4,0,30,26,10.0,7.44
180,0.78,5,0,36,31,10.0,7.8
181,0.84,2,0,32,30,10.0,8.4
182,0.698,5,0,27,22,10.0,6.98
183,0.912,2,0,29,27,10.0,9.12
184,0.836,4,0,34,30,10.0,8.36
185,0.76,3,0,22,19,10.0,7.6
186,0.79,3,0,15,12,10.0,7.9
187,0.832,4,0,27,23,10.0,8.32
188,0.68,4,0,20,16,10.0,6.8
189,0.736,6,0,29,23,10.0,7.36
190,0.68,6,0,24,18,10.0,6.8
191,0.768,5,0,25,20,10.0,7.68
192,0.8,3,0,26,23,10.0,8.0
193,0.744,4,0,25,21,10.0,7.44
194,0.768,4,0,26,22,10.0,7.68
195,0.72,4,0,23,19,10.0,7.2
196,0.748,6,0,37,31,10.0,7.48
197,0.766,8,0,35,27,10.0,7.66
198,0.892,4,0,26,22,10.0,8.92
199,0.82,2,0,28,26,10.0,8.2
200,0.743,5,0,27,22,10.0,7.43
201,0.808,5,0,31,26,10.0,8.08
202,0.825,2,0,21,19,10.0,8.25
203,0.76,4,0,26,22,10.0,7.6
204,0.668,5,0,21,16,10.0,6.68
205,0.722,5,0,24,19,10.0,7.22
206,0.744,5,0,22,17,10.0,7.44
207,0.772,4,0,28,24,10.0,7.72
208,0.682,6,0,22,16,10.0,6.82
209,0.82,5,0,21,16,10.0,8.2
210,0.855,3,0,15,12,10.0,8.55
211,0.83,2,0,15,13,10.0,8.3
212,0.694,5,0,28,23,10.0,6.94
213,0.738,6,0,29,23,10.0,7.38
214,0.71,5,0,20,15,10.0,7.1
215,0.68,5,0,25,20,10.0,6.8
216,0.94,3,0,25,22,10.0,9.4
217,0.656,6,0,29,23,10.0,6.56
218,0.736,7,0,35,28,10.0,7.36
219,0.752,5,0,25,20,10.0,7.52
220,0.738,5,0,27,22,10.0,7.38
221,0.8,2,0,18,16,10.0,8.0
222,0.8,3,0,26,23,10.0,8.0
223,0.646,6,0,25,19,10.0,6.46
224,0.797,3,0,25,22,10.0,7.97
225,0.788,7,0,31,24,10.0,7.88
226,0.74,5,0,36,31,10.0,7.4
227,0.715,5,0,22,17,10.0,7.15
228,0.832,4,0,30,26,10.0,8.32
229,0.649,7,0,27,20,10.0,6.49
230,0.84,3,0,29,26,10.0,8.4
231,0.744,6,0,33,27,10.0,7.44
232,0.75,2,0,14,12,10.0,7.5
233,0.76,4,0,24,20,10.0,7.6
234,0.754,5,0,26,21,10.0,7.54
235,0.729,6,0,31,25,10.0,7.29
236,0.68,4,0,24,20,10.0,6.8
237,0.8,4,0,28,24,10.0,8.0
238,0.788,5,0,25,20,10.0,7.88
239,0.696,5,0,30,25,10.0,6.96
240,0.649,6,0,24,18,10.0,6.49
241,0.72,6,0,23,17,10.0,7.2
242,0.694,7,0,27,20,10.0,6.94
243,0.804,3,0,19,16,10.0,8.04
244,0.636,7,0,32,25,10.0,6.36
245,0.804,5,0,28,23,10.0,8.04
246,0.892,3,0,31,28,10.0,8.92
247,0.76,3,0,18,15,10.0,7.6
248,0.75,3,0,22,19,10.0,7.5
249,0.797,5,0,30,25,10.0,7.97
250,0.803,4,0,26,22,10.0,8.03
251,0.795,3,0,40,37,10.0,7.95
252,0.778,6,0,29,23,10.0,7.78
253,0.706,6,0,29,23,10.0,7.06
254,0.76,3,0,19,16,10.0,7.6
255,0.816,5,0,33,28,10.0,8.16
256,0.6,7,0,23,16,10.0,6.0
257,0.892,2,0,30,28,10.0,8.92
258,0.712,6,0,29,23,10.0,7.12
259,0.85,3,0,20,17,10.0,8.5
260,0.68,4,0,21,17,10.0,6.8
261,0.768,4,0,28,24,10.0,7.68
262,0.728,5,0,30,25,10.0,7.28
263,0.852,3,0,28,25,10.0,8.52
264,0.739,5,0,26,21,10.0,7.39
265,0.77,4,0,19,15,10.0,7.7
266,0.812,3,0,25,22,10.0,8.12
267,0.615,8,0,26,18,10.0,6.15
268,0.8,8,0,35,27,10.0,8.0
269,0.724,7,0,27,20,10.0,7.24
270,0.672,5,0,26,21,10.0,6.72
271,0.816,4,0,26,22,10.0,8.16
272,0.8,3,0,24,21,10.0,8.0
273,0.769,6,0,28,22,10.0,7.69
274,0.756,5,0,27,22,10.0,7.56
275,0.748,4,0,30,26,10.0,7.48
276,0.68,6,0,31,25,10.0,6.8
277,0.76,4,0,21,17,10.0,7.6
278,0.828,5,0,28,23,10.0,8.28
279,0.74,3,0,20,17,10.0,7.4
280,0.698,6,0,25,19,10.0,6.98
281,0.84,3,0,31,28,10.0,8.4
282,0.642,9,0,32,23,10.0,6.42
283,0.738,5,0,29,24,10.0,7.38
284,0.768,6,0,27,21,10.0,7.68
285,0.865,2,0,17,15,10.0,8.65
286,0.775,4,0,27,23,10.0,7.75
287,0.736,8,0,37,29,10.0,7.36
288,0.806,5,0,31,26,10.0,8.06
289,0.795,3,0,19,16,10.0,7.95
290,0.88,2,0,20,18,10.0,8.8
291,0.88,2,0,22,20,10.0,8.8
292,0.706,5,0,28,23,10.0,7.06
293,0.694,8,0,27,19,10.0,6.94
294,0.796,5,0,25,20,10.0,7.96
295,0.731,5,0,25,20,10.0,7.31
296,0.724,6,0,27,21,10.0,7.24
297,0.648,7,0,23,16,10.0,6.48
298,0.585,7,0,20,13,10.0,5.85
299,0.743,5,0,32,27,10.0,7.43
300,0.72,8,0,32,24,10.0,7.2
301,0.704,5,0,29,24,10.0,7.04
302,0.78,3,0,24,21,10.0,7.8
303,0.76,5,0,24,19,10.0,7.6
304,0.542,8,0,24,16,10.0,5.42
305,0.6,4,0,15,11,10.0,6.0
306,0.852,3,0,28,25,10.0,8.52
307,0.772,4,0,26,22,10.0,7.72
308,0.747,5,0,27,22,10.0,7.47
309,0.69,4,0,23,19,10.0,6.9
310,0.625,4,0,19,15,10.0,6.25
311,0.743,5,0,26,21,10.0,7.43
312,0.844,6,0,37,31,10.0,8.44
313,0.723,6,0,26,20,10.0,7.23
314,0.75,4,0,25,21,10.0,7.5
315,0.74,6,0,28,22,10.0,7.4
316,0.732,5,0,27,22,10.0,7.32
317,0.9,1,0,19,18,10.0,9.0
318,0.925,1,0,20,19,10.0,9.25
319,0.6,4,0,16,12,10.0,6.0
320,0.76,4,0,28,24,10.0,7.6
321,0.706,4,0,23,19,10.0,7.06
322,0.768,4,0,30,26,10.0,7.68
323,0.815,5,0,28,23,10.0,8.15
324,0.712,4,0,27,23,10.0,7.12
325,0.7,4,0,20,16,10.0,7.0
326,0.823,3,0,26,23,10.0,8.23
327,0.675,5,0,28,23,10.0,6.75
328,0.866,3,0,30,27,10.0,8.66
329,0.69,5,0,26,21,10.0,6.9
330,0.708,6,0,30,24,10.0,7.08
331,0.792,3,0,23,20,10.0,7.92
332,0.788,3,0,21,18,10.0,7.88
333,0.73,5,0,26,21,10.0,7.3
334,0.646,7,0,25,18,10.0,6.46
335,0.82,6,0,31,25,10.0,8.2
336,0.779,4,0,30,26,10.0,7.79
337,0.71,4,0,17,13,10.0,7.1
338,0.624,8,0,28,20,10.0,6.24
339,0.701,6,0,28,22,10.0,7.01
340,0.679,4,0,26,22,10.0,6.79
341,0.836,4,0,30,26,10.0,8.36
342,0.82,2,0,18,16,10.0,8.2
343,0.805,6,0,26,20,10.0,8.05
344,0.776,6,0,34,28,10.0,7.76
345,0.82,4,0,30,26,10.0,8.2
346,0.74,3,0,18,15,10.0,7.4
347,0.787,4,0,27,23,10.0,7.87
348,0.825,4,0,30,26,10.0,8.25
349,0.712,7,0,26,19,10.0,7.12
350,0.765,4,0,22,18,10.0,7.65
351,0.72,7,0,32,25,10.0,7.2
352,0.718,7,0,31,24,10.0,7.18
353,0.904,2,0,24,22,10.0,9.04
354,0.742,7,0,29,22,10.0,7.42
355,0.682,6,0,28,22,10.0,6.82
356,0.61,6,0,18,12,10.0,6.1
357,0.82,2,0,18,16,10.0,8.2
358,0.784,4,0,27,23,10.0,7.84
359,0.725,4,0,23,19,10.0,7.25
360,0.744,5,0,33,28,10.0,7.44
361,0.68,5,0,23,18,10.0,6.8
362,0.778,6,0,29,23,10.0,7.78
363,0.676,5,0,19,14,10.0,6.76
364,0.776,3,0,20,17,10.0,7.76
365,0.78,4,0,24,20,10.0,7.8
366,0.676,9,0,33,24,10.0,6.76
367,0.775,2,0,17,15,10.0,7.75
368,0.788,5,0,26,21,10.0,7.88
369,0.88,5,0,31,26,10.0,8.8
370,0.76,6,0,29,23,10.0,7.6
371,0.756,3,0,24,21,10.0,7.56
372,0.74,5,0,29,24,10.0,7.4
373,0.732,6,0,28,22,10.0,7.32
374,0.602,5,0,27,22,10.0,6.02
375,0.856,6,0,28,22,10.0,8.56
376,0.803,3,0,25,22,10.0,8.03
377,0.8,2,0,20,18,10.0,8.0
378,0.72,4,0,21,17,10.0,7.2
379,0.828,3,0,31,28,10.0,8.28
380,0.761,7,0,28,21,10.0,7.61
381,0.82,3,0,17,14,10.0,8.2
382,0.744,7,0,38,31,10.0,7.44
383,0.698,6,0,29,23,10.0,6.98
384,0.693,5,0,22,17,10.0,6.93
385,0.876,2,0,19,17,10.0,8.76
386,0.75,6,0,25,19,10.0,7.5
387,0.704,5,0,22,17,10.0,7.04
388,0.7,3,0,16,13,10.0,7.0
389,0.832,4,0,26,22,10.0,8.32
390,0.79,5,0,31,26,10.0,7.9
391,0.7,7,0,28,21,10.0,7.0
392,0.865,2,0,19,17,10.0,8.65
393,0.718,6,0,26,20,10.0,7.18
394,0.844,3,0,26,23,10.0,8.44
395,0.85,3,0,33,30,10.0,8.5
396,0.625,4,0,22,18,10.0,6.25
397,0.75,2,0,12,10,10.0,7.5
398,0.776,5,0,30,25,10.0,7.76
399,0.78,3,0,20,17,10.0,7.8
400,0.9,2,0,19,17,10.0,9.0
401,0.64,7,0,26,19,10.0,6.4
402,0.8,4,0,25,21,10.0,8.0
403,0.84,2,0,32,30,10.0,8.4
404,0.704,5,0,27,22,10.0,7.04
405,0.769,5,0,24,19,10.0,7.69
406,0.76,3,0,14,11,10.0,7.6
407,0.765,3,0,25,22,10.0,7.65
408,0.744,4,0,30,26,10.0,7.44
409,0.784,5,0,33,28,10.0,7.84
410,0.7,6,0,26,20,10.0,7.0
411,0.802,5,0,24,19,10.0,8.02
412,0.66,6,0,21,15,10.0,6.6
413,0.776,3,0,26,23,10.0,7.76
414,0.58,7,0,23,16,10.0,5.8
415,0.701,7,0,27,20,10.0,7.01
416,0.712,4,0,24,20,10.0,7.12
417,0.74,3,0,16,13,10.0,7.4
418,0.776,6,0,31,25,10.0,7.76
419,0.814,4,0,26,22,10.0,8.14
420,0.678,13,0,40,27,10.0,6.78
421,0.748,7,0,32,25,10.0,7.48
422,0.744,6,0,38,32,10.0,7.44
423,0.672,5,0,32,27,10.0,6.72
424,0.872,2,0,30,28,10.0,8.72
425,0.85,3,0,15,12,10.0,8.5
426,0.68,6,0,24,18,10.0,6.8
427,0.76,5,0,26,21,10.0,7.6
428,0.685,5,0,23,18,10.0,6.85
429,0.875,2,0,13,11,10.0,8.75
430,0.736,10,0,39,29,10.0,7.36
431,0.689,4,0,21,17,10.0,6.89
432,0.744,4,0,26,22,10.0,7.44
433,0.682,6,0,24,18,10.0,6.82
434,0.803,3,0,24,21,10.0,8.03
435,0.746,8,0,42,34,10.0,7.46
436,0.65,4,0,17,13,10.0,6.5
437,0.804,4,0,28,24,10.0,8.04
438,0.76,3,0,16,13,10.0,7.6
439,0.847,3,0,27,24,10.0,8.47
440,0.796,4,0,33,29,10.0,7.96
441,0.788,4,0,28,24,10.0,7.88
442,0.798,4,0,25,21,10.0,7.98
443,0.744,6,0,27,21,10.0,7.44
444,0.74,4,0,18,14,10.0,7.4
445,0.715,4,0,23,19,10.0,7.15
446,0.768,5,0,31,26,10.0,7.68
447,0.74,4,0,25,21,10.0,7.4
448,0.815,7,0,25,18,10.0,8.15
449,0.74,6,0,27,21,10.0,7.4
450,0.76,3,0,21,18,10.0,7.6
451,0.742,8,0,35,27,10.0,7.42
452,0.84,2,0,30,28,10.0,8.4
453,0.692,9,0,36,27,10.0,6.92
454,0.78,8,0,35,27,10.0,7.8
455,0.832,4,0,36,32,10.0,8.32
456,0.828,4,0,38,34,10.0,8.28
457,0.755,3,0,17,14,10.0,7.55
458,0.789,6,0,37,31,10.0,7.89
459,0.713,5,0,32,27,10.0,7.13
460,0.812,6,0,28,22,10.0,8.12
461,0.74,4,0,22,18,10.0,7.4
462,0.672,6,0,30,24,10.0,6.72
463,0.767,7,0,31,24,10.0,7.67
464,0.797,7,0,28,21,10.0,7.97
465,0.712,5,0,26,21,10.0,7.12
466,0.808,4,0,24,20,10.0,8.08
467,0.756,5,0,27,22,10.0,7.56
468,0.744,4,0,32,28,10.0,7.44
469,0.671,6,0,26,20,10.0,6.71
470,0.776,3,0,22,19,10.0,7.76
471,0.7,3,0,23,20,10.0,7.0
472,0.806,7,0,26,19,10.0,8.06
473,0.845,5,0,24,19,10.0,8.45
474,0.759,4,0,29,25,10.0,7.59
475,0.716,5,0,25,20,10.0,7.16
476,0.76,3,0,18,15,10.0,7.6
477,0.732,8,0,29,21,10.0,7.32
478,0.744,5,0,27,22,10.0,7.44
479,0.76,4,0,33,29,10.0,7.6
480,0.828,7,0,41,34,10.0,8.28
481,0.814,5,0,32,27,10.0,8.14
482,0.795,3,0,24,21,10.0,7.95
483,0.782,5,0,27,22,10.0,7.82
484,0.828,9,0,40,31,10.0,8.28
485,0.806,6,0,24,18,10.0,8.06
486,0.8,4,0,24,20,10.0,8.0
487,0.76,4,0,25,21,10.0,7.6
488,0.79,4,0,28,24,10.0,7.9
489,0.79,5,0,27,22,10.0,7.9
490,0.726,6,0,27,21,10.0,7.26
491,0.74,4,0,24,20,10.0,7.4
492,0.868,4,0,26,22,10.0,8.68
493,0.728,4,0,21,17,10.0,7.28
494,0.856,4,0,37,33,10.0,8.56
495,0.685,7,0,28,21,10.0,6.85
496,0.709,7,0,28,21,10.0,7.09
497,0.86,3,0,22,19,10.0,8.6
498,0.71,5,0,21,16,10.0,7.1
499,0.764,4,0,34,30,10.0,7.64
500,0.754,11,0,26,15,10.0,7.54
501,0.796,4,0,25,21,10.0,7.96
502,0.804,3,0,26,23,10.0,8.04
503,0.871,3,0,30,27,10.0,8.71
504,0.792,4,0,28,24,10.0,7.92
505,0.72,5,0,25,20,10.0,7.2
506,0.745,4,0,26,22,10.0,7.45
507,0.732,5,0,29,24,10.0,7.32
508,0.804,5,0,32,27,10.0,8.04
509,0.752,5,0,31,26,10.0,7.52
510,0.585,5,0,16,11,10.0,5.85
511,0.758,7,0,28,21,10.0,7.58
512,0.865,2,0,26,24,10.0,8.65
513,0.82,4,0,27,23,10.0,8.2
514,0.793,8,0,38,30,10.0,7.93
515,0.735,4,0,21,17,10.0,7.35
516,0.792,3,0,29,26,10.0,7.92
517,0.688,5,0,25,20,10.0,6.88
518,0.82,3,0,25,22,10.0,8.2
519,0.608,7,0,24,17,10.0,6.08
520,0.91,2,0,17,15,10.0,9.1
521,0.81,3,0,30,27,10.0,8.1
522,0.669,5,0,30,25,10.0,6.69
523,0.75,3,0,26,23,10.0,7.5
524,0.817,4,0,28,24,10.0,8.17
525,0.76,3,0,21,18,10.0,7.6
526,0.88,2,0,18,16,10.0,8.8
527,0.8,5,0,29,24,10.0,8.0
528,0.86,5,0,33,28,10.0,8.6
529,0.894,4,0,35,31,10.0,8.94
530,0.636,6,0,29,23,10.0,6.36
531,0.763,5,0,28,23,10.0,7.63
532,0.736,7,0,28,21,10.0,7.36
533,0.753,4,0,25,21,10.0,7.53
534,0.784,4,0,27,23,10.0,7.84
535,0.775,3,0,20,17,10.0,7.75
536,0.93,2,0,17,15,10.0,9.3
537,0.78,3,0,27,24,10.0,7.8
538,0.824,4,0,31,27,10.0,8.24
539,0.725,3,0,21,18,10.0,7.25
540,0.735,4,0,18,14,10.0,7.35
541,0.752,6,0,32,26,10.0,7.52
542,0.8,2,0,18,16,10.0,8.0
543,0.864,4,0,35,31,10.0,8.64
544,0.801,4,0,33,29,10.0,8.01
545,0.761,5,0,28,23,10.0,7.61
546,0.715,3,0,19,16,10.0,7.15
547,0.84,2,0,16,14,10.0,8.4
548,0.797,6,0,27,21,10.0,7.97
549,0.626,6,0,22,16,10.0,6.26
550,0.872,2,0,36,34,10.0,8.72
551,0.872,2,0,27,25,10.0,8.72
552,0.74,3,0,26,23,10.0,7.4
553,0.813,5,0,24,19,10.0,8.13
554,0.832,3,0,24,21,10.0,8.32
555,0.85,2,0,27,25,10.0,8.5
556,0.775,2,0,16,14,10.0,7.75
557,0.806,6,0,39,33,10.0,8.06
558,0.668,7,0,25,18,10.0,6.68
559,0.741,9,0,35,26,10.0,7.41
560,0.746,6,0,29,23,10.0,7.46
561,0.836,7,0,29,22,10.0,8.36
562,0.652,7,0,29,22,10.0,6.52
563,0.723,6,0,31,25,10.0,7.23
564,0.68,6,0,28,22,10.0,6.8
565,0.7,4,0,27,23,10.0,7.0
566,0.73,5,0,22,17,10.0,7.3
567,0.698,6,0,25,19,10.0,6.98
568,0.78,6,0,31,25,10.0,7.8
569,0.775,3,0,20,17,10.0,7.75
570,0.796,4,0,28,24,10.0,7.96
571,0.775,3,0,26,23,10.0,7.75
572,0.69,4,0,29,25,10.0,6.9
573,0.774,6,0,29,23,10.0,7.74
574,0.692,7,0,32,25,10.0,6.92
575,0.745,5,0,22,17,10.0,7.45
576,0.774,5,0,25,20,10.0,7.74
577,0.76,5,0,30,25,10.0,7.6
578,0.73,6,0,26,20,10.0,7.3
579,0.695,5,0,31,26,10.0,6.95
580,0.767,5,0,28,23,10.0,7.67
581,0.84,2,0,22,20,10.0,8.4
582,0.84,7,0,26,19,10.0,8.4
583,0.711,6,0,28,22,10.0,7.11
584,0.725,4,0,29,25,10.0,7.25
585,0.68,4,0,17,13,10.0,6.8
586,0.82,4,0,27,23,10.0,8.2
587,0.683,8,0,31,23,10.0,6.83
588,0.925,1,0,17,16,10.0,9.25
589,0.8,2,0,24,22,10.0,8.0
590,0.752,4,0,23,19,10.0,7.52
591,0.566,8,0,26,18,10.0,5.66
592,0.66,6,0,30,24,10.0,6.6
593,0.748,9,0,39,30,10.0,7.48
594,0.724,5,0,29,24,10.0,7.24
595,0.952,1,0,17,16,10.0,9.52
596,0.83,2,0,24,22,10.0,8.3
597,0.7,5,0,26,21,10.0,7.0
598,0.755,4,0,19,15,10.0,7.55
599,0.755,3,0,17,14,10.0,7.55
600,0.706,6,0,33,27,10.0,7.06
601,0.788,5,0,34,29,10.0,7.88
602,0.823,5,0,29,24,10.0,8.23
603,0.785,3,0,23,20,10.0,7.85
604,0.844,5,0,36,31,10.0,8.44
605,0.732,5,0,27,22,10.0,7.32
606,0.591,8,0,27,19,10.0,5.91
607,0.7,5,0,21,16,10.0,7.0
608,0.74,4,0,27,23,10.0,7.4
609,0.655,7,0,25,18,10.0,6.55
610,0.8,3,0,35,32,10.0,8.0
611,0.744,5,0,27,22,10.0,7.44
612,0.736,6,0,36,30,10.0,7.36
613,0.73,8,0,31,23,10.0,7.3
614,0.74,5,0,27,22,10.0,7.4
615,0.791,4,0,26,22,10.0,7.91
616,0.776,4,0,22,18,10.0,7.76
617,0.8,2,0,15,13,10.0,8.0
618,0.76,4,0,21,17,10.0,7.6
619,0.875,2,0,13,11,10.0,8.75
620,0.695,4,0,19,15,10.0,6.95
621,0.86,2,0,15,13,10.0,8.6
622,0.764,3,0,23,20,10.0,7.64
623,0.68,6,0,27,21,10.0,6.8
624,0.82,2,0,17,15,10.0,8.2
625,0.808,3,0,27,24,10.0,8.08
626,0.784,5,0,30,25,10.0,7.84
627,0.685,5,0,26,21,10.0,6.85
628,0.628,8,0,30,22,10.0,6.28
629,0.75,3,0,24,21,10.0,7.5
630,0.79,3,0,25,22,10.0,7.9
631,0.72,6,0,29,23,10.0,7.2
632,0.837,3,0,24,21,10.0,8.37
633,0.802,5,0,27,22,10.0,8.02
634,0.84,3,0,32,29,10.0,8.4
635,0.808,5,0,36,31,10.0,8.08
636,0.73,5,0,23,18,10.0,7.3
637,0.784,5,0,23,18,10.0,7.84
638,0.581,8,0,24,16,10.0,5.81
639,0.712,7,0,29,22,10.0,7.12
640,0.828,5,0,32,27,10.0,8.28
641,0.75,2,0,23,21,10.0,7.5
642,0.714,6,0,33,27,10.0,7.14
643,0.735,10,0,39,29,10.0,7.35
644,0.805,4,0,26,22,10.0,8.05
645,0.792,3,0,28,25,10.0,7.92
646,0.744,5,0,31,26,10.0,7.44
647,0.7,4,0,22,18,10.0,7.0
648,0.82,3,0,31,28,10.0,8.2
649,0.675,4,0,19,15,10.0,6.75
650,0.636,6,0,25,19,10.0,6.36
651,0.68,4,0,24,20,10.0,6.8
652,0.808,4,0,26,22,10.0,8.08
653,0.727,6,0,34,28,10.0,7.27
654,0.728,6,0,26,20,10.0,7.28
655,0.728,6,0,25,19,10.0,7.28
656,0.708,6,0,23,17,10.0,7.08
657,0.776,4,0,28,24,10.0,7.76
658,0.826,3,0,21,18,10.0,8.26
659,0.708,4,0,28,24,10.0,7.08
660,0.735,4,0,26,22,10.0,7.35
661,0.752,4,0,27,23,10.0,7.52
662,0.751,6,0,34,28,10.0,7.51
663,0.816,5,0,26,21,10.0,8.16
664,0.808,4,0,30,26,10.0,8.08
665,0.804,4,0,25,21,10.0,8.04
666,0.78,5,0,24,19,10.0,7.8
667,0.772,5,0,24,19,10.0,7.72
668,0.808,6,0,37,31,10.0,8.08
669,0.675,3,0,14,11,10.0,6.75
670,0.755,4,0,24,20,10.0,7.55
671,0.84,2,0,15,13,10.0,8.4
672,0.665,4,0,19,15,10.0,6.65
673,0.66,4,0,16,12,10.0,6.6
674,0.69,8,0,38,30,10.0,6.9
675,0.76,7,0,30,23,10.0,7.6
676,0.776,6,0,31,25,10.0,7.76
677,0.712,6,0,27,21,10.0,7.12
678,0.724,4,0,29,25,10.0,7.24
679,0.756,6,0,34,28,10.0,7.56
680,0.765,5,0,24,19,10.0,7.65
681,0.748,4,0,28,24,10.0,7.48
682,0.778,5,0,29,24,10.0,7.78
683,0.84,3,0,27,24,10.0,8.4
684,0.852,3,0,39,36,10.0,8.52
685,0.86,2,0,18,16,10.0,8.6
686,0.742,7,0,30,23,10.0,7.42
687,0.698,5,0,31,26,10.0,6.98
688,0.792,3,0,29,26,10.0,7.92
689,0.805,3,0,20,17,10.0,8.05
690,0.752,5,0,32,27,10.0,7.52
691,0.84,2,0,23,21,10.0,8.4
692,0.757,5,0,28,23,10.0,7.57
693,0.808,4,0,29,25,10.0,8.08
694,0.825,2,0,18,16,10.0,8.25
695,0.796,5,0,31,26,10.0,7.96
696,0.82,3,0,19,16,10.0,8.2
697,0.7,4,0,25,21,10.0,7.0
698,0.79,5,0,40,35,10.0,7.9
699,0.72,4,0,28,24,10.0,7.2
700,0.59,5,0,16,11,10.0,5.9
701,0.776,4,0,29,25,10.0,7.76
702,0.645,5,0,21,16,10.0,6.45
703,0.76,5,0,26,21,10.0,7.6
704,0.727,6,0,31,25,10.0,7.27
705,0.756,5,0,32,27,10.0,7.56
706,0.818,4,0,30,26,10.0,8.18
707,0.88,5,0,28,23,10.0,8.8
708,0.796,7,0,40,33,10.0,7.96
709,0.84,2,0,25,23,10.0,8.4
710,0.772,3,0,20,17,10.0,7.72
711,0.714,7,0,30,23,10.0,7.14
712,0.728,4,0,27,23,10.0,7.28
713,0.785,3,0,18,15,10.0,7.85
714,0.728,5,0,25,20,10.0,7.28
715,0.778,5,0,33,28,10.0,7.78
716,0.735,4,0,18,14,10.0,7.35
717,0.676,4,0,25,21,10.0,6.76
718,0.796,5,0,29,24,10.0,7.96
719,0.682,5,0,25,20,10.0,6.82
720,0.79,3,0,17,14,10.0,7.9
721,0.875,2,0,18,16,10.0,8.75
722,0.716,5,0,32,27,10.0,7.16
723,0.77,3,0,18,15,10.0,7.7
724,0.785,4,0,24,20,10.0,7.85
725,0.7,6,0,26,20,10.0,7.0
726,0.846,4,0,28,24,10.0,8.46
727,0.765,3,0,20,17,10.0,7.65
728,0.625,9,0,28,19,10.0,6.25
729,0.672,6,0,30,24,10.0,6.72
730,0.676,6,0,27,21,10.0,6.76
731,0.826,5,0,34,29,10.0,8.26
732,0.68,6,0,33,27,10.0,6.8
733,0.762,5,0,27,22,10.0,7.62
734,0.658,6,0,27,21,10.0,6.58
735,0.71,6,0,26,20,10.0,7.1
736,0.78,6,0,37,31,10.0,7.8
737,0.828,5,0,31,26,10.0,8.28
738,0.772,5,0,27,22,10.0,7.72
739,0.845,2,0,18,16,10.0,8.45
740,0.764,5,0,27,22,10.0,7.64
741,0.76,5,0,25,20,10.0,7.6
742,0.874,3,0,30,27,10.0,8.74
743,0.856,3,0,30,27,10.0,8.56
744,0.776,5,0,27,22,10.0,7.76
745,0.784,5,0,27,22,10.0,7.84
746,0.85,3,0,28,25,10.0,8.5
747,0.88,4,0,28,24,10.0,8.8
748,0.824,3,0,34,31,10.0,8.24
749,0.756,5,0,33,28,10.0,7.56
750,0.72,4,0,20,16,10.0,7.2
751,0.78,4,0,29,25,10.0,7.8
752,0.67,4,0,16,12,10.0,6.7
753,0.79,4,0,18,14,10.0,7.9
754,0.745,5,0,21,16,10.0,7.45
755,0.76,3,0,29,26,10.0,7.6
756,0.835,3,0,16,13,10.0,8.35
757,0.808,4,0,26,22,10.0,8.08
758,0.76,3,0,20,17,10.0,7.6
759,0.697,6,0,35,29,10.0,6.97
760,0.844,3,0,30,27,10.0,8.44
761,0.644,6,0,26,20,10.0,6.44
762,0.752,4,0,27,23,10.0,7.52
763,0.848,3,0,34,31,10.0,8.48
764,0.805,5,0,30,25,10.0,8.05
765,0.7,4,0,23,19,10.0,7.0
766,0.816,5,0,26,21,10.0,8.16
767,0.722,5,0,29,24,10.0,7.22
768,0.858,3,0,28,25,10.0,8.58
769,0.78,3,0,18,15,10.0,7.8
770,0.68,6,0,23,17,10.0,6.8
771,0.712,8,0,27,19,10.0,7.12
772,0.8,2,0,18,16,10.0,8.0
773,0.76,3,0,21,18,10.0,7.6
774,0.872,2,0,26,24,10.0,8.72
775,0.82,3,0,24,21,10.0,8.2
776,0.66,6,0,28,22,10.0,6.6
777,0.765,3,0,27,24,10.0,7.65
778,0.736,6,0,30,24,10.0,7.36
779,0.75,3,0,24,21,10.0,7.5
780,0.749,4,0,27,23,10.0,7.49
781,0.775,2,0,22,20,10.0,7.75
782,0.744,4,0,24,20,10.0,7.44
783,0.86,3,0,26,23,10.0,8.6
784,0.587,6,0,29,23,10.0,5.87
785,0.668,5,0,21,16,10.0,6.68
786,0.79,5,0,29,24,10.0,7.9
787,0.85,2,0,20,18,10.0,8.5
788,0.708,5,0,27,22,10.0,7.08
789,0.75,3,0,26,23,10.0,7.5
790,0.73,5,0,25,20,10.0,7.3
791,0.76,4,0,16,12,10.0,7.6
792,0.72,4,0,28,24,10.0,7.2
793,0.648,5,0,29,24,10.0,6.48
794,0.784,5,0,33,28,10.0,7.84
795,0.744,5,0,28,23,10.0,7.44
796,0.792,3,0,30,27,10.0,7.92
797,0.664,6,0,29,23,10.0,6.64
798,0.794,7,0,31,24,10.0,7.94
799,0.732,6,0,30,24,10.0,7.32
800,0.708,7,0,32,25,10.0,7.08
801,0.8,4,0,20,16,10.0,8.0
802,0.748,5,0,35,30,10.0,7.48
803,0.66,6,0,29,23,10.0,6.6
804,0.793,4,0,27,23,10.0,7.93
805,0.76,3,0,18,15,10.0,7.6
806,0.691,6,0,27,21,10.0,6.91
807,0.86,3,0,20,17,10.0,8.6
808,0.872,3,0,28,25,10.0,8.72
809,0.74,3,0,24,21,10.0,7.4
810,0.812,6,0,35,29,10.0,8.12
811,0.68,5,0,26,21,10.0,6.8
812,0.779,4,0,27,23,10.0,7.79
813,0.772,4,0,28,24,10.0,7.72
814,0.748,5,0,21,16,10.0,7.48
815,0.85,2,0,18,16,10.0,8.5
816,0.7,4,0,16,12,10.0,7.0
817,0.731,4,0,30,26,10.0,7.31
818,0.8,2,0,17,15,10.0,8.0
819,0.777,7,0,30,23,10.0,7.77
820,0.655,6,0,26,20,10.0,6.55
821,0.776,4,0,24,20,10.0,7.76
822,0.776,5,0,33,28,10.0,7.76
823,0.76,3,0,27,24,10.0,7.6
824,0.82,3,0,19,16,10.0,8.2
825,0.716,5,0,25,20,10.0,7.16
826,0.76,4,0,25,21,10.0,7.6
827,0.808,5,0,29,24,10.0,8.08
828,0.816,3,0,21,18,10.0,8.16
829,0.625,3,0,13,10,10.0,6.25
830,0.705,4,0,19,15,10.0,7.05
831,0.64,8,0,30,22,10.0,6.4
832,0.816,3,0,29,26,10.0,8.16
833,0.84,4,0,27,23,10.0,8.4
834,0.82,4,0,21,17,10.0,8.2
835,0.764,5,0,26,21,10.0,7.64
836,0.68,4,0,23,19,10.0,6.8
837,0.9,1,0,13,12,10.0,9.0
838,0.76,3,0,25,22,10.0,7.6
839,0.84,2,0,16,14,10.0,8.4
840,0.788,5,0,36,31,10.0,7.88
841,0.738,6,0,33,27,10.0,7.38
842,0.78,3,0,27,24,10.0,7.8
843,0.76,3,0,23,20,10.0,7.6
844,0.78,3,0,22,19,10.0,7.8
845,0.832,4,0,29,25,10.0,8.32
846,0.742,7,0,29,22,10.0,7.42
847,0.792,4,0,30,26,10.0,7.92
848,0.71,7,0,37,30,10.0,7.1
849,0.792,5,0,33,28,10.0,7.92
850,0.827,4,0,29,25,10.0,8.27
851,0.72,4,0,22,18,10.0,7.2
852,0.72,4,0,25,21,10.0,7.2
853,0.74,3,0,25,22,10.0,7.4
854,0.707,5,0,25,20,10.0,7.07
855,0.73,5,0,21,16,10.0,7.3
856,0.68,4,0,25,21,10.0,6.8
857,0.856,5,0,32,27,10.0,8.56
858,0.74,7,0,39,32,10.0,7.4
859,0.85,2,0,18,16,10.0,8.5
860,0.707,7,0,31,24,10.0,7.07
861,0.812,4,0,26,22,10.0,8.12
862,0.9,3,0,27,24,10.0,9.0
863,0.646,6,0,23,17,10.0,6.46
864,0.8,3,0,19,16,10.0,8.0
865,0.776,4,0,28,24,10.0,7.76
866,0.783,5,0,27,22,10.0,7.83
867,0.7,4,0,24,20,10.0,7.0
868,0.8,2,0,19,17,10.0,8.0
869,0.86,3,0,21,18,10.0,8.6
870,0.744,4,0,28,24,10.0,7.44
871,0.675,3,0,17,14,10.0,6.75
872,0.794,4,0,30,26,10.0,7.94
873,0.74,4,0,23,19,10.0,7.4
874,0.712,4,0,28,24,10.0,7.12
875,0.78,3,0,21,18,10.0,7.8
876,0.625,4,0,16,12,10.0,6.25
877,0.81,3,0,18,15,10.0,8.1
878,0.752,5,0,27,22,10.0,7.52
879,0.78,4,0,26,22,10.0,7.8
880,0.752,5,0,27,22,10.0,7.52
881,0.846,5,0,33,28,10.0,8.46
882,0.7,4,0,24,20,10.0,7.0
883,0.818,6,0,29,23,10.0,8.18
884,0.63,4,0,18,14,10.0,6.3
885,0.78,4,0,27,23,10.0,7.8
886,0.712,5,0,29,24,10.0,7.12
887,0.724,6,0,26,20,10.0,7.24
888,0.672,8,0,30,22,10.0,6.72
889,0.825,2,0,18,16,10.0,8.25
890,0.68,6,0,21,15,10.0,6.8
891,0.692,6,0,25,19,10.0,6.92
892,0.784,6,0,21,15,10.0,7.84
893,0.808,7,0,38,31,10.0,8.08
894,0.64,5,0,24,19,10.0,6.4
895,0.815,4,0,30,26,10.0,8.15
896,0.792,4,0,27,23,10.0,7.92
897,0.804,3,0,27,24,10.0,8.04
898,0.714,5,0,30,25,10.0,7.14
899,0.86,2,0,25,23,10.0,8.6
900,0.74,4,0,30,26,10.0,7.4
901,0.712,6,0,28,22,10.0,7.12
902,0.666,6,0,26,20,10.0,6.66
903,0.68,4,0,23,19,10.0,6.8
904,0.732,5,0,26,21,10.0,7.32
905,0.625,4,0,15,11,10.0,6.25
906,0.788,6,0,30,24,10.0,7.88
907,0.772,5,0,25,20,10.0,7.72
908,0.776,4,0,26,22,10.0,7.76
909,0.751,8,0,33,25,10.0,7.51
910,0.76,5,0,29,24,10.0,7.6
911,0.766,4,0,27,23,10.0,7.66
912,0.7,5,0,27,22,10.0,7.0
913,0.72,4,0,20,16,10.0,7.2
914,0.84,3,0,36,33,10.0,8.4
915,0.776,5,0,31,26,10.0,7.76
916,0.734,6,0,41,35,10.0,7.34
917,0.748,7,0,28,21,10.0,7.48
918,0.765,5,0,27,22,10.0,7.65
919,0.659,6,0,25,19,10.0,6.59
920,0.736,4,0,27,23,10.0,7.36
921,0.744,6,0,28,22,10.0,7.44
922,0.732,5,0,22,17,10.0,7.32
923,0.872,2,0,36,34,10.0,8.72
924,0.66,5,0,19,14,10.0,6.6
925,0.736,9,0,33,24,10.0,7.36
926,0.76,3,0,14,11,10.0,7.6
927,0.89,3,0,22,19,10.0,8.9
928,0.848,3,0,25,22,10.0,8.48
929,0.725,3,0,16,13,10.0,7.25
930,0.725,4,0,29,25,10.0,7.25
931,0.778,5,0,28,23,10.0,7.78
932,0.718,7,0,27,20,10.0,7.18
933,0.824,4,0,37,33,10.0,8.24
934,0.781,5,0,28,23,10.0,7.81
935,0.8,3,0,26,23,10.0,8.0
936,0.672,7,0,26,19,10.0,6.72
937,0.751,5,0,28,23,10.0,7.51
938,0.826,3,0,32,29,10.0,8.26
939,0.785,3,0,24,21,10.0,7.85
940,0.7,8,0,28,20,10.0,7.0
941,0.78,3,0,27,24,10.0,7.8
942,0.82,2,0,22,20,10.0,8.2
943,0.675,3,0,14,11,10.0,6.75
944,0.86,3,0,35,32,10.0,8.6
945,0.752,4,0,26,22,10.0,7.52
946,0.81,6,0,36,30,10.0,8.1
947,0.775,4,0,18,14,10.0,7.75
948,0.78,3,0,30,27,10.0,7.8
949,0.815,2,0,18,16,10.0,8.15
950,0.75,4,0,26,22,10.0,7.5
951,0.854,3,0,28,25,10.0,8.54
952,0.854,3,0,27,24,10.0,8.54
953,0.702,4,0,28,24,10.0,7.02
954,0.839,4,0,27,23,10.0,8.39
955,0.665,6,0,26,20,10.0,6.65
956,0.767,5,0,26,21,10.0,7.67
957,0.758,6,0,27,21,10.0,7.58
958,0.776,5,0,36,31,10.0,7.76
959,0.75,6,0,36,30,10.0,7.5
960,0.704,5,0,26,21,10.0,7.04
961,0.688,13,0,39,26,10.0,6.88
962,0.656,6,0,24,18,10.0,6.56
963,0.76,5,0,28,23,10.0,7.6
964,0.754,7,0,36,29,10.0,7.54
965,0.787,4,0,33,29,10.0,7.87
966,0.712,4,0,23,19,10.0,7.12
967,0.824,4,0,27,23,10.0,8.24
968,0.822,4,0,32,28,10.0,8.22
969,0.73,5,0,21,16,10.0,7.3
970,0.75,2,0,24,22,10.0,7.5
971,0.688,4,0,22,18,10.0,6.88
972,0.768,6,0,30,24,10.0,7.68
973,0.71,4,0,18,14,10.0,7.1
974,0.692,6,0,25,19,10.0,6.92
975,0.748,5,0,27,22,10.0,7.48
976,0.68,4,0,25,21,10.0,6.8
977,0.766,5,0,23,18,10.0,7.66
978,0.705,5,0,23,18,10.0,7.05
979,0.752,3,0,30,27,10.0,7.52
980,0.795,5,0,31,26,10.0,7.95
981,0.738,6,0,27,21,10.0,7.38
982,0.778,6,0,37,31,10.0,7.78
983,0.714,4,0,25,21,10.0,7.14
984,0.81,4,0,23,19,10.0,8.1
985,0.815,3,0,20,17,10.0,8.15
986,0.797,6,0,32,26,10.0,7.97
987,0.776,6,0,24,18,10.0,7.76
988,0.87,4,0,37,33,10.0,8.7
989,0.758,5,0,31,26,10.0,7.58
990,0.775,2,0,20,18,10.0,7.75
991,0.76,5,0,29,24,10.0,7.6
992,0.742,6,0,25,19,10.0,7.42
993,0.768,5,0,37,32,10.0,7.68
994,0.766,7,0,25,18,10.0,7.66
995,0.696,6,0,27,21,10.0,6.96
996,0.722,6,0,27,21,10.0,7.22
997,0.8,2,0,21,19,10.0,8.0
998,0.73,4,0,17,13,10.0,7.3
999,0.752,6,0,34,28,10.0,7.52
1000,0.87,2,0,24,22,10.0,8.7
1001,0.701,7,0,27,20,10.0,7.01
1002,0.815,3,0,24,21,10.0,8.15
1003,0.752,4,0,25,21,10.0,7.52
1004,0.852,5,0,22,17,10.0,8.52
1005,0.656,7,0,27,20,10.0,6.56
1006,0.736,6,0,26,20,10.0,7.36
1007,0.638,8,0,25,17,10.0,6.38
1008,0.842,4,0,27,23,10.0,8.42
1009,0.74,4,0,27,23,10.0,7.4
1010,0.744,4,0,20,16,10.0,7.44
1011,0.792,3,0,25,22,10.0,7.92
1012,0.712,8,0,36,28,10.0,7.12
1013,0.814,4,0,26,22,10.0,8.14
1014,0.84,2,0,28,26,10.0,8.4
1015,0.704,5,0,24,19,10.0,7.04
1016,0.708,5,0,25,20,10.0,7.08
1017,0.752,6,0,35,29,10.0,7.52
1018,0.71,4,0,20,16,10.0,7.1
1019,0.87,2,0,21,19,10.0,8.7
1020,0.748,5,0,26,21,10.0,7.48
1021,0.82,3,0,22,19,10.0,8.2
1022,0.859,3,0,29,26,10.0,8.59
1023,0.748,7,0,33,26,10.0,7.48
1024,0.675,4,0,18,14,10.0,6.75
1025,0.84,2,0,21,19,10.0,8.4
1026,0.722,7,0,26,19,10.0,7.22
1027,0.752,6,0,27,21,10.0,7.52
1028,0.872,4,0,32,28,10.0,8.72
1029,0.684,5,0,28,23,10.0,6.84
1030,0.68,6,0,25,19,10.0,6.8
1031,0.696,7,0,28,21,10.0,6.96
1032,0.762,6,0,33,27,10.0,7.62
1033,0.904,2,0,17,15,10.0,9.04
1034,0.832,4,0,23,19,10.0,8.32
1035,0.76,3,0,17,14,10.0,7.6
1036,0.725,5,0,19,14,10.0,7.25
1037,0.725,4,0,13,9,10.0,7.25
1038,0.728,6,0,30,24,10.0,7.28
1039,0.72,6,0,26,20,10.0,7.2
1040,0.675,4,0,18,14,10.0,6.75
1041,0.744,5,0,27,22,10.0,7.44
1042,0.746,5,0,35,30,10.0,7.46
1043,0.644,9,0,27,18,10.0,6.44
1044,0.824,4,0,35,31,10.0,8.24
1045,0.754,7,0,22,15,10.0,7.54
1046,0.749,4,0,29,25,10.0,7.49
1047,0.704,6,0,27,21,10.0,7.04
1048,0.736,7,0,40,33,10.0,7.36
1049,0.704,6,0,27,21,10.0,7.04
1050,0.778,5,0,22,17,10.0,7.78
1051,0.733,5,0,31,26,10.0,7.33
1052,0.564,8,0,28,20,10.0,5.64
1053,0.768,4,0,28,24,10.0,7.68
1054,0.788,4,0,30,26,10.0,7.88
1055,0.656,8,0,35,27,10.0,6.56
1056,0.715,3,0,16,13,10.0,7.15
1057,0.739,9,0,28,19,10.0,7.39
1058,0.8,3,0,20,17,10.0,8.0
1059,0.79,3,0,21,18,10.0,7.9
1060,0.706,7,0,35,28,10.0,7.06
1061,0.8,4,0,34,30,10.0,8.0
1062,0.686,6,0,28,22,10.0,6.86
1063,0.8,4,0,27,23,10.0,8.0
1064,0.716,7,0,27,20,10.0,7.16
1065,0.7,3,0,14,11,10.0,7.0
1066,0.792,5,0,27,22,10.0,7.92
1067,0.84,3,0,21,18,10.0,8.4
1068,0.716,5,0,32,27,10.0,7.16
1069,0.775,2,0,20,18,10.0,7.75
1070,0.819,6,0,25,19,10.0,8.19
1071,0.786,4,0,29,25,10.0,7.86
1072,0.78,5,0,27,22,10.0,7.8
1073,0.764,4,0,33,29,10.0,7.64
1074,0.659,7,0,21,14,10.0,6.59
1075,0.652,6,0,25,19,10.0,6.52
1076,0.778,5,0,33,28,10.0,7.78
1077,0.712,6,0,23,17,10.0,7.12
1078,0.76,4,0,31,27,10.0,7.6
1079,0.726,5,0,24,19,10.0,7.26
1080,0.8,4,0,22,18,10.0,8.0
1081,0.736,4,0,30,26,10.0,7.36
1082,0.808,7,0,33,26,10.0,8.08
1083,0.741,4,0,27,23,10.0,7.41
1084,0.792,3,0,27,24,10.0,7.92
1085,0.784,4,0,23,19,10.0,7.84
1086,0.725,3,0,27,24,10.0,7.25
1087,0.804,6,0,36,30,10.0,8.04
1088,0.77,6,0,32,26,10.0,7.7
1089,0.66,5,0,30,25,10.0,6.6
1090,0.742,6,0,31,25,10.0,7.42
1091,0.75,4,0,20,16,10.0,7.5
1092,0.64,5,0,29,24,10.0,6.4
1093,0.8,4,0,24,20,10.0,8.0
1094,0.616,8,0,31,23,10.0,6.16
1095,0.668,5,0,27,22,10.0,6.68
1096,0.708,6,0,28,22,10.0,7.08
1097,0.657,7,0,26,19,10.0,6.57
1098,0.759,5,0,30,25,10.0,7.59
1099,0.611,8,0,25,17,10.0,6.11
1100,0.804,7,0,35,28,10.0,8.04
1101,0.64,4,0,15,11,10.0,6.4
1102,0.692,7,0,30,23,10.0,6.92
1103,0.83,3,0,25,22,10.0,8.3
1104,0.9,1,0,12,11,10.0,9.0
1105,0.668,5,0,26,21,10.0,6.68
1106,0.855,3,0,26,23,10.0,8.55
1107,0.744,4,0,27,23,10.0,7.44
1108,0.68,4,0,22,18,10.0,6.8
1109,0.85,3,0,26,23,10.0,8.5
1110,0.536,9,0,24,15,10.0,5.36
1111,0.704,5,0,27,22,10.0,7.04
1112,0.776,4,0,29,25,10.0,7.76
1113,0.729,6,0,29,23,10.0,7.29
1114,0.65,4,0,14,10,10.0,6.5
1115,0.728,7,0,31,24,10.0,7.28
1116,0.825,2,0,12,10,10.0,8.25
1117,0.785,3,0,27,24,10.0,7.85
1118,0.776,5,0,31,26,10.0,7.76
1119,0.695,4,0,23,19,10.0,6.95
1120,0.814,5,0,32,27,10.0,8.14
1121,0.744,6,0,32,26,10.0,7.44
1122,0.75,5,0,23,18,10.0,7.5
1123,0.66,5,0,21,16,10.0,6.6
1124,0.86,2,0,21,19,10.0,8.6
1125,0.805,3,0,21,18,10.0,8.05
1126,0.754,6,0,30,24,10.0,7.54
1127,0.866,3,0,24,21,10.0,8.66
1128,0.832,3,0,34,31,10.0,8.32
1129,0.628,6,0,24,18,10.0,6.28
1130,0.688,5,0,29,24,10.0,6.88
1131,0.716,4,0,23,19,10.0,7.16
1132,0.76,3,0,19,16,10.0,7.6
1133,0.696,6,0,27,21,10.0,6.96
1134,0.824,3,0,27,24,10.0,8.24
1135,0.772,4,0,25,21,10.0,7.72
1136,0.8,3,0,17,14,10.0,8.0
1137,0.772,4,0,27,23,10.0,7.72
1138,0.75,4,0,22,18,10.0,7.5
1139,0.778,6,0,24,18,10.0,7.78
1140,0.77,5,0,28,23,10.0,7.7
1141,0.865,2,0,23,21,10.0,8.65
1142,0.736,5,0,30,25,10.0,7.36
1143,0.795,2,0,15,13,10.0,7.95
1144,0.752,7,0,33,26,10.0,7.52
1145,0.68,5,0,18,13,10.0,6.8
1146,0.74,4,0,26,22,10.0,7.4
1147,0.744,5,0,32,27,10.0,7.44
1148,0.82,4,0,20,16,10.0,8.2
1149,0.736,6,0,28,22,10.0,7.36
1150,0.848,10,0,43,33,10.0,8.48
1151,0.75,4,0,23,19,10.0,7.5
1152,0.64,4,0,15,11,10.0,6.4
1153,0.709,6,0,29,23,10.0,7.09
1154,0.8,5,0,30,25,10.0,8.0
1155,0.886,3,0,28,25,10.0,8.86
1156,0.84,4,0,24,20,10.0,8.4
1157,0.78,3,0,27,24,10.0,7.8
1158,0.776,3,0,28,25,10.0,7.76
1159,0.75,5,0,22,17,10.0,7.5
1160,0.79,5,0,25,20,10.0,7.9
1161,0.768,5,0,27,22,10.0,7.68
1162,0.792,3,0,21,18,10.0,7.92
1163,0.88,2,0,25,23,10.0,8.8
1164,0.746,4,0,20,16,10.0,7.46
1165,0.766,6,0,28,22,10.0,7.66
1166,0.802,6,0,35,29,10.0,8.02
1167,0.672,5,0,22,17,10.0,6.72
1168,0.678,6,0,27,21,10.0,6.78
1169,0.76,8,0,32,24,10.0,7.6
1170,0.84,3,0,26,23,10.0,8.4
1171,0.772,3,0,25,22,10.0,7.72
1172,0.78,6,0,24,18,10.0,7.8
1173,0.84,3,0,24,21,10.0,8.4
1174,0.808,4,0,34,30,10.0,8.08
1175,0.754,5,0,35,30,10.0,7.54
1176,0.76,3,0,21,18,10.0,7.6
1177,0.724,11,0,38,27,10.0,7.24
1178,0.731,6,0,25,19,10.0,7.31
1179,0.72,6,0,25,19,10.0,7.2
1180,0.71,4,0,18,14,10.0,7.1
1181,0.776,4,0,27,23,10.0,7.76
1182,0.835,3,0,16,13,10.0,8.35
1183,0.696,7,0,30,23,10.0,6.96
1184,0.88,3,0,19,16,10.0,8.8
1185,0.816,4,0,29,25,10.0,8.16
1186,0.8,4,0,33,29,10.0,8.0
1187,0.708,6,0,30,24,10.0,7.08
1188,0.69,4,0,24,20,10.0,6.9
1189,0.728,4,0,21,17,10.0,7.28
1190,0.656,7,0,32,25,10.0,6.56
1191,0.73,11,0,42,31,10.0,7.3
1192,0.776,5,0,31,26,10.0,7.76
1193,0.84,2,0,16,14,10.0,8.4
1194,0.68,6,0,26,20,10.0,6.8
1195,0.759,7,0,37,30,10.0,7.59
1196,0.712,6,0,29,23,10.0,7.12
1197,0.748,5,0,28,23,10.0,7.48
1198,0.784,5,0,31,26,10.0,7.84
1199,0.804,4,0,24,20,10.0,8.04
1200,0.798,7,0,41,34,10.0,7.98
1201,0.71,4,0,22,18,10.0,7.1
1202,0.85,2,0,21,19,10.0,8.5
1203,0.795,3,0,22,19,10.0,7.95
1204,0.6,7,0,25,18,10.0,6.0
1205,0.708,5,0,28,23,10.0,7.08
1206,0.816,5,0,31,26,10.0,8.16
1207,0.694,6,0,28,22,10.0,6.94
1208,0.743,5,0,21,16,10.0,7.43
1209,0.815,4,0,17,13,10.0,8.15
1210,0.856,3,0,24,21,10.0,8.56
1211,0.76,4,0,20,16,10.0,7.6
1212,0.808,3,0,28,25,10.0,8.08
1213,0.763,4,0,22,18,10.0,7.63
1214,0.795,2,0,24,22,10.0,7.95
1215,0.76,5,0,30,25,10.0,7.6
1216,0.756,5,0,28,23,10.0,7.56
1217,0.74,3,0,15,12,10.0,7.4
1218,0.8,4,0,27,23,10.0,8.0
1219,0.84,2,0,32,30,10.0,8.4
1220,0.81,3,0,20,17,10.0,8.1
1221,0.764,4,0,29,25,10.0,7.64
1222,0.796,3,0,27,24,10.0,7.96
1223,0.735,7,0,28,21,10.0,7.35
1224,0.82,5,0,41,36,10.0,8.2
1225,0.741,6,0,27,21,10.0,7.41
1226,0.775,6,0,29,23,10.0,7.75
1227,0.718,8,0,22,14,10.0,7.18
1228,0.772,4,0,23,19,10.0,7.72
1229,0.72,7,0,31,24,10.0,7.2
1230,0.725,3,0,16,13,10.0,7.25
1231,0.76,4,0,24,20,10.0,7.6
1232,0.808,3,0,26,23,10.0,8.08
1233,0.804,4,0,28,24,10.0,8.04
1234,0.744,5,0,27,22,10.0,7.44
1235,0.73,4,0,31,27,10.0,7.3
1236,0.78,4,0,26,22,10.0,7.8
1237,0.8,4,0,23,19,10.0,8.0
1238,0.768,9,0,34,25,10.0,7.68
1239,0.792,6,0,30,24,10.0,7.92
1240,0.656,6,0,24,18,10.0,6.56
1241,0.872,2,0,29,27,10.0,8.72
1242,0.795,3,0,23,20,10.0,7.95
1243,0.84,3,0,26,23,10.0,8.4
1244,0.69,4,0,31,27,10.0,6.9
1245,0.712,4,0,19,15,10.0,7.12
1246,0.762,9,0,37,28,10.0,7.62
1247,0.775,2,0,16,14,10.0,7.75
1248,0.85,2,0,11,9,10.0,8.5
1249,0.72,5,0,28,23,10.0,7.2
1250,0.71,5,0,17,12,10.0,7.1
1251,0.832,3,0,30,27,10.0,8.32
1252,0.745,4,0,23,19,10.0,7.45
1253,0.68,6,0,27,21,10.0,6.8
1254,0.796,5,0,27,22,10.0,7.96
1255,0.68,6,0,27,21,10.0,6.8
1256,0.76,5,0,29,24,10.0,7.6
1257,0.68,4,0,18,14,10.0,6.8
1258,0.82,3,0,26,23,10.0,8.2
1259,0.788,4,0,31,27,10.0,7.88
1260,0.82,5,0,38,33,10.0,8.2
1261,0.756,4,0,25,21,10.0,7.56
1262,0.744,5,0,29,24,10.0,7.44
1263,0.664,9,0,34,25,10.0,6.64
1264,0.82,2,0,25,23,10.0,8.2
1265,0.672,5,0,38,33,10.0,6.72
1266,0.805,3,0,17,14,10.0,8.05
1267,0.788,9,0,39,30,10.0,7.88
1268,0.74,3,0,24,21,10.0,7.4
1269,0.74,5,0,26,21,10.0,7.4
1270,0.72,4,0,26,22,10.0,7.2
1271,0.788,4,0,28,24,10.0,7.88
1272,0.752,4,0,21,17,10.0,7.52
1273,0.795,2,0,14,12,10.0,7.95
1274,0.6,6,0,18,12,10.0,6.0
1275,0.752,4,0,28,24,10.0,7.52
1276,0.725,9,0,32,23,10.0,7.25
1277,0.712,6,0,28,22,10.0,7.12
1278,0.638,7,0,28,21,10.0,6.38
1279,0.7,6,0,28,22,10.0,7.0
1280,0.78,3,0,18,15,10.0,7.8
1281,0.71,4,0,19,15,10.0,7.1
1282,0.752,3,0,23,20,10.0,7.52
1283,0.8,8,0,37,29,10.0,8.0
1284,0.68,4,0,14,10,10.0,6.8
1285,0.84,2,0,27,25,10.0,8.4
1286,0.544,7,0,22,15,10.0,5.44
1287,0.808,4,0,28,24,10.0,8.08
1288,0.72,5,0,33,28,10.0,7.2
1289,0.656,6,0,29,23,10.0,6.56
1290,0.693,5,0,25,20,10.0,6.93
1291,0.84,4,0,27,23,10.0,8.4
1292,0.64,4,0,21,17,10.0,6.4
1293,0.67,7,0,28,21,10.0,6.7
1294,0.616,6,0,26,20,10.0,6.16
1295,0.74,3,0,15,12,10.0,7.4
1296,0.736,6,0,28,22,10.0,7.36
1297,0.679,7,0,25,18,10.0,6.79
1298,0.775,2,0,14,12,10.0,7.75
1299,0.737,4,0,27,23,10.0,7.37
1300,0.839,4,0,27,23,10.0,8.39
1301,0.826,5,0,28,23,10.0,8.26
1302,0.775,3,0,19,16,10.0,7.75
1303,0.829,6,0,34,28,10.0,8.29
1304,0.742,6,0,29,23,10.0,7.42
1305,0.718,6,0,29,23,10.0,7.18
1306,0.832,3,0,28,25,10.0,8.32
1307,0.82,2,0,19,17,10.0,8.2
1308,0.755,4,0,21,17,10.0,7.55
1309,0.658,9,0,30,21,10.0,6.58
1310,0.746,4,0,27,23,10.0,7.46
1311,0.8,3,0,17,14,10.0,8.0
1312,0.824,5,0,33,28,10.0,8.24
1313,0.78,3,0,23,20,10.0,7.8
1314,0.824,5,0,23,18,10.0,8.24
1315,0.728,4,0,26,22,10.0,7.28
1316,0.772,6,0,36,30,10.0,7.72
1317,0.6,4,0,15,11,10.0,6.0
1318,0.815,2,0,13,11,10.0,8.15
1319,0.776,4,0,28,24,10.0,7.76
1320,0.755,4,0,18,14,10.0,7.55
1321,0.725,6,0,35,29,10.0,7.25
1322,0.744,4,0,30,26,10.0,7.44
1323,0.744,4,0,26,22,10.0,7.44
1324,0.8,2,0,26,24,10.0,8.0
1325,0.784,5,0,21,16,10.0,7.84
1326,0.835,6,0,31,25,10.0,8.35
1327,0.696,5,0,26,21,10.0,6.96
1328,0.78,7,0,37,30,10.0,7.8
1329,0.6,4,0,27,23,10.0,6.0
1330,0.83,3,0,20,17,10.0,8.3
1331,0.792,7,0,32,25,10.0,7.92
1332,0.62,5,0,23,18,10.0,6.2
1333,0.754,6,0,31,25,10.0,7.54
1334,0.776,6,0,34,28,10.0,7.76
1335,0.75,3,0,21,18,10.0,7.5
1336,0.695,4,0,18,14,10.0,6.95
1337,0.59,5,0,15,10,10.0,5.9
1338,0.884,2,0,30,28,10.0,8.84
1339,0.8,2,0,15,13,10.0,8.0
1340,0.75,4,0,24,20,10.0,7.5
1341,0.865,3,0,28,25,10.0,8.65
1342,0.63,4,0,22,18,10.0,6.3
1343,0.696,4,0,20,16,10.0,6.96
1344,0.8,3,0,27,24,10.0,8.0
1345,0.732,6,0,27,21,10.0,7.32
1346,0.79,4,0,26,22,10.0,7.9
1347,0.756,3,0,26,23,10.0,7.56
1348,0.94,2,0,17,15,10.0,9.4
1349,0.68,5,0,27,22,10.0,6.8
1350,0.738,7,0,34,27,10.0,7.38
1351,0.727,5,0,24,19,10.0,7.27
1352,0.69,8,0,30,22,10.0,6.9
1353,0.808,4,0,35,31,10.0,8.08
1354,0.64,6,0,26,20,10.0,6.4
1355,0.664,5,0,21,16,10.0,6.64
1356,0.734,7,0,37,30,10.0,7.34
1357,0.796,5,0,28,23,10.0,7.96
1358,0.755,3,0,19,16,10.0,7.55
1359,0.823,4,0,34,30,10.0,8.23
1360,0.78,3,0,23,20,10.0,7.8
1361,0.8,5,0,38,33,10.0,8.0
1362,0.796,10,0,37,27,10.0,7.96
1363,0.71,7,0,30,23,10.0,7.1
1364,0.828,7,0,34,27,10.0,8.28
1365,0.788,5,0,28,23,10.0,7.88
1366,0.698,5,0,29,24,10.0,6.98
1367,0.84,2,0,28,26,10.0,8.4
1368,0.754,4,0,28,24,10.0,7.54
1369,0.756,6,0,32,26,10.0,7.56
1370,0.748,6,0,29,23,10.0,7.48
1371,0.708,5,0,25,20,10.0,7.08
1372,0.592,7,0,27,20,10.0,5.92
1373,0.64,4,0,24,20,10.0,6.4
1374,0.668,7,0,29,22,10.0,6.68
1375,0.776,4,0,30,26,10.0,7.76
1376,0.775,3,0,28,25,10.0,7.75
1377,0.675,4,0,18,14,10.0,6.75
1378,0.808,4,0,31,27,10.0,8.08
1379,0.65,3,0,25,22,10.0,6.5
1380,0.6,8,0,27,19,10.0,6.0
1381,0.74,4,0,26,22,10.0,7.4
1382,0.872,5,0,40,35,10.0,8.72
1383,0.775,3,0,19,16,10.0,7.75
1384,0.778,7,0,32,25,10.0,7.78
1385,0.76,5,0,18,13,10.0,7.6
1386,0.766,6,0,27,21,10.0,7.66
1387,0.714,6,0,28,22,10.0,7.14
1388,0.805,3,0,23,20,10.0,8.05
1389,0.9,2,0,19,17,10.0,9.0
1390,0.844,4,0,28,24,10.0,8.44
1391,0.74,4,0,25,21,10.0,7.4
1392,0.64,4,0,19,15,10.0,6.4
1393,0.79,5,0,25,20,10.0,7.9
1394,0.752,5,0,30,25,10.0,7.52
1395,0.806,5,0,28,23,10.0,8.06
1396,0.844,3,0,32,29,10.0,8.44
1397,0.712,6,0,31,25,10.0,7.12
1398,0.736,9,0,35,26,10.0,7.36
1399,0.752,5,0,30,25,10.0,7.52
1400,0.9,1,0,19,18,10.0,9.0
1401,0.742,7,0,31,24,10.0,7.42
1402,0.744,4,0,22,18,10.0,7.44
1403,0.736,6,0,25,19,10.0,7.36
1404,0.738,6,0,27,21,10.0,7.38
1405,0.692,6,0,27,21,10.0,6.92
1406,0.86,4,0,38,34,10.0,8.6
1407,0.69,6,0,31,25,10.0,6.9
1408,0.804,4,0,30,26,10.0,8.04
1409,0.708,10,0,35,25,10.0,7.08
1410,0.77,5,0,30,25,10.0,7.7
1411,0.735,4,0,19,15,10.0,7.35
1412,0.776,4,0,26,22,10.0,7.76
1413,0.7,5,0,23,18,10.0,7.0
1414,0.744,5,0,35,30,10.0,7.44
1415,0.756,5,0,27,22,10.0,7.56
1416,0.795,2,0,20,18,10.0,7.95
1417,0.765,3,0,16,13,10.0,7.65
1418,0.606,7,0,30,23,10.0,6.06
1419,0.744,4,0,20,16,10.0,7.44
1420,0.72,4,0,25,21,10.0,7.2
1421,0.744,5,0,29,24,10.0,7.44
1422,0.8,4,0,24,20,10.0,8.0
1423,0.704,5,0,26,21,10.0,7.04
1424,0.744,4,0,25,21,10.0,7.44
1425,0.72,6,0,23,17,10.0,7.2
1426,0.79,3,0,20,17,10.0,7.9
1427,0.677,6,0,28,22,10.0,6.77
1428,0.663,4,0,22,18,10.0,6.63
1429,0.804,3,0,29,26,10.0,8.04
1430,0.672,7,0,27,20,10.0,6.72
1431,0.815,3,0,17,14,10.0,8.15
1432,0.748,6,0,32,26,10.0,7.48
1433,0.775,4,0,27,23,10.0,7.75
1434,0.753,4,0,27,23,10.0,7.53
1435,0.748,6,0,34,28,10.0,7.48
1436,0.77,5,0,34,29,10.0,7.7
1437,0.816,6,0,33,27,10.0,8.16
1438,0.72,5,0,28,23,10.0,7.2
1439,0.75,4,0,30,26,10.0,7.5
1440,0.816,5,0,44,39,10.0,8.16
1441,0.66,5,0,17,12,10.0,6.6
1442,0.79,3,0,19,16,10.0,7.9
1443,0.768,4,0,26,22,10.0,7.68
1444,0.8,4,0,27,23,10.0,8.0
1445,0.858,5,0,39,34,10.0,8.58
1446,0.64,4,0,17,13,10.0,6.4
1447,0.855,3,0,19,16,10.0,8.55
1448,0.802,7,0,31,24,10.0,8.02
1449,0.89,2,0,21,19,10.0,8.9
1450,0.832,10,0,42,32,10.0,8.32
1451,0.86,2,0,19,17,10.0,8.6
1452,0.68,5,0,26,21,10.0,6.8
1453,0.83,3,0,17,14,10.0,8.3
1454,0.78,3,0,28,25,10.0,7.8
1455,0.824,3,0,27,24,10.0,8.24
1456,0.68,5,0,23,18,10.0,6.8
1457,0.732,4,0,21,17,10.0,7.32
1458,0.842,5,0,32,27,10.0,8.42
1459,0.77,5,0,24,19,10.0,7.7
1460,0.72,5,0,26,21,10.0,7.2
1461,0.736,5,0,28,23,10.0,7.36
1462,0.699,5,0,26,21,10.0,6.99
1463,0.782,4,0,26,22,10.0,7.82
1464,0.796,5,0,26,21,10.0,7.96
1465,0.76,5,0,27,22,10.0,7.6
1466,0.792,4,0,26,22,10.0,7.92
1467,0.587,8,0,23,15,10.0,5.87
1468,0.868,3,0,21,18,10.0,8.68
1469,0.75,3,0,18,15,10.0,7.5
1470,0.8,2,0,19,17,10.0,8.0
1471,0.835,3,0,30,27,10.0,8.35
1472,0.7,3,0,20,17,10.0,7.0
1473,0.68,5,0,34,29,10.0,6.8
1474,0.81,3,0,19,16,10.0,8.1
1475,0.739,4,0,23,19,10.0,7.39
1476,0.684,11,0,40,29,10.0,6.84
1477,0.68,4,0,19,15,10.0,6.8
1478,0.8,2,0,18,16,10.0,8.0
1479,0.75,2,0,19,17,10.0,7.5
1480,0.742,4,0,26,22,10.0,7.42
1481,0.775,2,0,20,18,10.0,7.75
1482,0.72,5,0,29,24,10.0,7.2
1483,0.808,4,0,27,23,10.0,8.08
1484,0.7,4,0,22,18,10.0,7.0
1485,0.872,2,0,30,28,10.0,8.72
1486,0.824,4,0,23,19,10.0,8.24
1487,0.835,4,0,24,20,10.0,8.35
1488,0.712,6,0,27,21,10.0,7.12
1489,0.824,4,0,27,23,10.0,8.24
1490,0.7,4,0,18,14,10.0,7.0
1491,0.764,4,0,25,21,10.0,7.64
1492,0.896,4,0,25,21,10.0,8.96
1493,0.824,4,0,26,22,10.0,8.24
1494,0.665,4,0,19,15,10.0,6.65
1495,0.696,6,0,32,26,10.0,6.96
1496,0.676,5,0,26,21,10.0,6.76
1497,0.788,8,0,34,26,10.0,7.88
1498,0.81,4,0,20,16,10.0,8.1
1499,0.708,7,0,23,16,10.0,7.08
1500,0.738,5,0,28,23,10.0,7.38
1501,0.792,3,0,25,22,10.0,7.92
1502,0.672,7,0,29,22,10.0,6.72
1503,0.792,4,0,28,24,10.0,7.92
1504,0.717,6,0,29,23,10.0,7.17
1505,0.872,2,0,33,31,10.0,8.72
1506,0.696,5,0,30,25,10.0,6.96
1507,0.632,6,0,23,17,10.0,6.32
1508,0.747,7,0,32,25,10.0,7.47
1509,0.76,3,0,17,14,10.0,7.6
1510,0.868,4,0,35,31,10.0,8.68
1511,0.76,4,0,21,17,10.0,7.6
1512,0.761,6,0,25,19,10.0,7.61
1513,0.756,4,0,29,25,10.0,7.56
1514,0.789,3,0,21,18,10.0,7.89
1515,0.808,4,0,28,24,10.0,8.08
1516,0.718,5,0,27,22,10.0,7.18
1517,0.7,5,0,20,15,10.0,7.0
1518,0.815,3,0,19,16,10.0,8.15
1519,0.842,4,0,27,23,10.0,8.42
1520,0.714,3,0,21,18,10.0,7.14
1521,0.792,5,0,24,19,10.0,7.92
1522,0.772,4,0,30,26,10.0,7.72
1523,0.764,4,0,26,22,10.0,7.64
1524,0.66,5,0,17,12,10.0,6.6
1525,0.728,4,0,23,19,10.0,7.28
1526,0.816,5,0,37,32,10.0,8.16
1527,0.728,5,0,27,22,10.0,7.28
1528,0.704,7,0,37,30,10.0,7.04
1529,0.795,3,0,24,21,10.0,7.95
1530,0.807,6,0,32,26,10.0,8.07
1531,0.765,3,0,13,10,10.0,7.65
1532,0.832,4,0,29,25,10.0,8.32
1533,0.75,3,0,17,14,10.0,7.5
1534,0.741,6,0,27,21,10.0,7.41
1535,0.664,7,0,30,23,10.0,6.64
1536,0.74,6,0,27,21,10.0,7.4
1537,0.768,4,0,27,23,10.0,7.68
1538,0.766,6,0,26,20,10.0,7.66
1539,0.7,3,0,15,12,10.0,7.0
1540,0.79,5,0,33,28,10.0,7.9
1541,0.71,5,0,19,14,10.0,7.1
1542,0.754,6,0,28,22,10.0,7.54
1543,0.803,6,0,32,26,10.0,8.03
1544,0.724,4,0,21,17,10.0,7.24
1545,0.76,5,0,23,18,10.0,7.6
1546,0.872,3,0,29,26,10.0,8.72
1547,0.845,2,0,22,20,10.0,8.45
1548,0.794,5,0,33,28,10.0,7.94
1549,0.672,6,0,28,22,10.0,6.72
1550,0.75,6,0,30,24,10.0,7.5
1551,0.728,6,0,32,26,10.0,7.28
1552,0.75,4,0,27,23,10.0,7.5
1553,0.728,5,0,24,19,10.0,7.28
1554,0.795,3,0,27,24,10.0,7.95
1555,0.794,6,0,30,24,10.0,7.94
1556,0.688,6,0,20,14,10.0,6.88
1557,0.75,4,0,26,22,10.0,7.5
1558,0.772,6,0,27,21,10.0,7.72
1559,0.812,3,0,26,23,10.0,8.12
1560,0.797,4,0,27,23,10.0,7.97
1561,0.804,6,0,34,28,10.0,8.04
1562,0.71,4,0,17,13,10.0,7.1
1563,0.772,5,0,29,24,10.0,7.72
1564,0.83,3,0,25,22,10.0,8.3
1565,0.76,4,0,25,21,10.0,7.6
1566,0.78,3,0,19,16,10.0,7.8
1567,0.76,3,0,24,21,10.0,7.6
1568,0.79,5,0,29,24,10.0,7.9
1569,0.79,4,0,26,22,10.0,7.9
1570,0.769,4,0,28,24,10.0,7.69
1571,0.75,4,0,24,20,10.0,7.5
1572,0.75,3,0,15,12,10.0,7.5
1573,0.765,4,0,25,21,10.0,7.65
1574,0.757,5,0,27,22,10.0,7.57
1575,0.82,2,0,36,34,10.0,8.2
1576,0.67,3,0,15,12,10.0,6.7
1577,0.744,5,0,31,26,10.0,7.44
1578,0.72,4,0,18,14,10.0,7.2
1579,0.77,4,0,20,16,10.0,7.7
1580,0.87,4,0,29,25,10.0,8.7
1581,0.81,3,0,20,17,10.0,8.1
1582,0.808,5,0,29,24,10.0,8.08
1583,0.78,3,0,18,15,10.0,7.8
1584,0.73,5,0,27,22,10.0,7.3
1585,0.788,7,0,31,24,10.0,7.88
1586,0.727,6,0,25,19,10.0,7.27
1587,0.564,8,0,27,19,10.0,5.64
1588,0.708,5,0,30,25,10.0,7.08
1589,0.771,4,0,34,30,10.0,7.71
1590,0.768,4,0,28,24,10.0,7.68
1591,0.675,5,0,19,14,10.0,6.75
1592,0.706,6,0,28,22,10.0,7.06
1593,0.784,4,0,34,30,10.0,7.84
1594,0.774,4,0,27,23,10.0,7.74
1595,0.844,4,0,30,26,10.0,8.44
1596,0.76,5,0,28,23,10.0,7.6
1597,0.86,2,0,22,20,10.0,8.6
1598,0.689,6,0,30,24,10.0,6.89
1599,0.644,7,0,28,21,10.0,6.44
1600,0.861,3,0,28,25,10.0,8.61
1601,0.832,5,0,25,20,10.0,8.32
1602,0.832,4,0,28,24,10.0,8.32
1603,0.829,3,0,23,20,10.0,8.29
1604,0.79,3,0,28,25,10.0,7.9
1605,0.725,5,0,24,19,10.0,7.25
1606,0.735,5,0,29,24,10.0,7.35
1607,0.68,6,0,30,24,10.0,6.8
1608,0.832,3,0,29,26,10.0,8.32
1609,0.865,2,0,27,25,10.0,8.65
1610,0.776,5,0,31,26,10.0,7.76
1611,0.715,3,0,14,11,10.0,7.15
1612,0.772,4,0,25,21,10.0,7.72
1613,0.84,5,0,40,35,10.0,8.4
1614,0.828,6,0,31,25,10.0,8.28
1615,0.744,5,0,37,32,10.0,7.44
1616,0.712,5,0,30,25,10.0,7.12
1617,0.72,4,0,23,19,10.0,7.2
1618,0.78,5,0,22,17,10.0,7.8
1619,0.811,4,0,22,18,10.0,8.11
1620,0.704,6,0,31,25,10.0,7.04
1621,0.684,6,0,27,21,10.0,6.84
1622,0.82,4,0,25,21,10.0,8.2
1623,0.75,3,0,20,17,10.0,7.5
1624,0.704,5,0,24,19,10.0,7.04
1625,0.655,4,0,17,13,10.0,6.55
1626,0.65,5,0,27,22,10.0,6.5
1627,0.784,4,0,25,21,10.0,7.84
1628,0.85,3,0,29,26,10.0,8.5
1629,0.901,3,0,26,23,10.0,9.01
1630,0.734,6,0,28,22,10.0,7.34
1631,0.654,4,0,23,19,10.0,6.54
1632,0.836,3,0,30,27,10.0,8.36
1633,0.744,7,0,33,26,10.0,7.44
1634,0.792,3,0,27,24,10.0,7.92
1635,0.76,4,0,29,25,10.0,7.6
1636,0.842,4,0,35,31,10.0,8.42
1637,0.82,5,0,28,23,10.0,8.2
1638,0.856,5,0,28,23,10.0,8.56
1639,0.783,5,0,27,22,10.0,7.83
1640,0.832,3,0,24,21,10.0,8.32
1641,0.733,6,0,32,26,10.0,7.33
1642,0.724,6,0,27,21,10.0,7.24
1643,0.856,3,0,29,26,10.0,8.56
1644,0.75,4,0,22,18,10.0,7.5
1645,0.745,3,0,18,15,10.0,7.45
1646,0.69,7,0,29,22,10.0,6.9
1647,0.689,5,0,26,21,10.0,6.89
1648,0.8,2,0,20,18,10.0,8.0
1649,0.718,6,0,35,29,10.0,7.18
1650,0.744,4,0,26,22,10.0,7.44
1651,0.828,4,0,26,22,10.0,8.28
1652,0.76,3,0,27,24,10.0,7.6
1653,0.76,3,0,25,22,10.0,7.6
1654,0.9,3,0,36,33,10.0,9.0
1655,0.761,5,0,23,18,10.0,7.61
1656,0.864,6,0,39,33,10.0,8.64
1657,0.74,3,0,28,25,10.0,7.4
1658,0.72,5,0,25,20,10.0,7.2
1659,0.8,3,0,29,26,10.0,8.0
1660,0.78,3,0,15,12,10.0,7.8
1661,0.88,2,0,15,13,10.0,8.8
1662,0.772,5,0,26,21,10.0,7.72
1663,0.76,3,0,32,29,10.0,7.6
1664,0.72,6,0,33,27,10.0,7.2
1665,0.75,2,0,27,25,10.0,7.5
1666,0.78,4,0,30,26,10.0,7.8
1667,0.688,5,0,25,20,10.0,6.88
1668,0.74,4,0,28,24,10.0,7.4
1669,0.76,4,0,34,30,10.0,7.6
1670,0.688,6,0,28,22,10.0,6.88
1671,0.736,6,0,33,27,10.0,7.36
1672,0.832,3,0,27,24,10.0,8.32
1673,0.784,4,0,26,22,10.0,7.84
1674,0.711,6,0,26,20,10.0,7.11
1675,0.78,7,0,32,25,10.0,7.8
1676,0.698,6,0,20,14,10.0,6.98
1677,0.662,5,0,19,14,10.0,6.62
1678,0.786,8,0,36,28,10.0,7.86
1679,0.795,3,0,26,23,10.0,7.95
1680,0.88,2,0,25,23,10.0,8.8
1681,0.7,4,0,22,18,10.0,7.0
1682,0.736,3,0,19,16,10.0,7.36
1683,0.76,3,0,22,19,10.0,7.6
1684,0.7,6,0,23,17,10.0,7.0
1685,0.78,6,0,35,29,10.0,7.8
1686,0.768,4,0,27,23,10.0,7.68
1687,0.846,6,0,25,19,10.0,8.46
1688,0.736,7,0,27,20,10.0,7.36
1689,0.78,3,0,19,16,10.0,7.8
1690,0.718,7,0,28,21,10.0,7.18
1691,0.732,4,0,25,21,10.0,7.32
1692,0.72,5,0,26,21,10.0,7.2
1693,0.668,7,0,28,21,10.0,6.68
1694,0.808,4,0,31,27,10.0,8.08
1695,0.8,2,0,24,22,10.0,8.0
1696,0.74,4,0,18,14,10.0,7.4
1697,0.67,5,0,27,22,10.0,6.7
1698,0.8,3,0,31,28,10.0,8.0
1699,0.792,6,0,34,28,10.0,7.92
1700,0.696,7,0,29,22,10.0,6.96
1701,0.838,5,0,30,25,10.0,8.38
1702,0.86,4,0,22,18,10.0,8.6
1703,0.789,4,0,28,24,10.0,7.89
1704,0.84,2,0,26,24,10.0,8.4
1705,0.724,6,0,31,25,10.0,7.24
1706,0.672,5,0,25,20,10.0,6.72
1707,0.662,6,0,25,19,10.0,6.62
1708,0.792,4,0,29,25,10.0,7.92
1709,0.849,4,0,32,28,10.0,8.49
1710,0.63,4,0,18,14,10.0,6.3
1711,0.712,7,0,31,24,10.0,7.12
1712,0.69,6,0,27,21,10.0,6.9
1713,0.776,4,0,28,24,10.0,7.76
1714,0.655,4,0,26,22,10.0,6.55
1715,0.812,4,0,37,33,10.0,8.12
1716,0.802,5,0,32,27,10.0,8.02
1717,0.816,5,0,33,28,10.0,8.16
1718,0.82,2,0,18,16,10.0,8.2
1719,0.696,6,0,24,18,10.0,6.96
1720,0.87,3,0,22,19,10.0,8.7
1721,0.78,6,0,37,31,10.0,7.8
1722,0.84,2,0,27,25,10.0,8.4
1723,0.824,4,0,24,20,10.0,8.24
1724,0.808,5,0,33,28,10.0,8.08
1725,0.762,8,0,40,32,10.0,7.62
1726,0.792,4,0,28,24,10.0,7.92
1727,0.645,5,0,28,23,10.0,6.45
1728,0.783,7,0,38,31,10.0,7.83
1729,0.696,6,0,18,12,10.0,6.96
1730,0.76,6,0,30,24,10.0,7.6
1731,0.704,6,0,21,15,10.0,7.04
1732,0.697,9,0,29,20,10.0,6.97
1733,0.86,3,0,28,25,10.0,8.6
1734,0.744,4,0,23,19,10.0,7.44
1735,0.824,5,0,24,19,10.0,8.24
1736,0.928,3,0,28,25,10.0,9.28
1737,0.8,2,0,18,16,10.0,8.0
1738,0.7,3,0,16,13,10.0,7.0
1739,0.7,5,0,27,22,10.0,7.0
1740,0.676,9,0,30,21,10.0,6.76
1741,0.75,3,0,23,20,10.0,7.5
1742,0.76,5,0,23,18,10.0,7.6
1743,0.66,6,0,28,22,10.0,6.6
1744,0.7,6,0,25,19,10.0,7.0
1745,0.855,2,0,21,19,10.0,8.55
1746,0.856,4,0,31,27,10.0,8.56
1747,0.8,4,0,24,20,10.0,8.0
1748,0.76,7,0,25,18,10.0,7.6
1749,0.7,3,0,24,21,10.0,7.0
1750,0.784,5,0,32,27,10.0,7.84
1751,0.862,6,0,28,22,10.0,8.62
1752,0.675,5,0,24,19,10.0,6.75
1753,0.82,2,0,25,23,10.0,8.2
1754,0.75,2,0,22,20,10.0,7.5
1755,0.792,4,0,20,16,10.0,7.92
1756,0.76,6,0,30,24,10.0,7.6
1757,0.86,5,0,32,27,10.0,8.6
1758,0.62,7,0,26,19,10.0,6.2
1759,0.7,4,0,21,17,10.0,7.0
1760,0.77,4,0,25,21,10.0,7.7
1761,0.71,6,0,32,26,10.0,7.1
1762,0.76,5,0,34,29,10.0,7.6
1763,0.789,4,0,31,27,10.0,7.89
1764,0.661,7,0,28,21,10.0,6.61
1765,0.64,5,0,27,22,10.0,6.4
1766,0.84,2,0,37,35,10.0,8.4
1767,0.77,5,0,31,26,10.0,7.7
1768,0.664,5,0,24,19,10.0,6.64
1769,0.691,4,0,24,20,10.0,6.91
1770,0.856,4,0,40,36,10.0,8.56
1771,0.63,9,0,27,18,10.0,6.3
1772,0.705,4,0,25,21,10.0,7.05
1773,0.728,4,0,25,21,10.0,7.28
1774,0.752,4,0,22,18,10.0,7.52
1775,0.787,5,0,32,27,10.0,7.87
1776,0.788,5,0,29,24,10.0,7.88
1777,0.72,3,0,14,11,10.0,7.2
1778,0.765,3,0,15,12,10.0,7.65
1779,0.729,4,0,23,19,10.0,7.29
1780,0.76,6,0,32,26,10.0,7.6
1781,0.728,5,0,29,24,10.0,7.28
1782,0.7,3,0,18,15,10.0,7.0
1783,0.823,5,0,32,27,10.0,8.23
1784,0.672,7,0,31,24,10.0,6.72
1785,0.704,6,0,31,25,10.0,7.04
1786,0.724,7,0,29,22,10.0,7.24
1787,0.824,6,0,35,29,10.0,8.24
1788,0.755,4,0,30,26,10.0,7.55
1789,0.86,2,0,28,26,10.0,8.6
1790,0.642,7,0,24,17,10.0,6.42
1791,0.72,5,0,26,21,10.0,7.2
1792,0.75,2,0,23,21,10.0,7.5
1793,0.775,2,0,14,12,10.0,7.75
1794,0.704,4,0,28,24,10.0,7.04
1795,0.762,5,0,25,20,10.0,7.62
1796,0.748,5,0,29,24,10.0,7.48
1797,0.834,5,0,34,29,10.0,8.34
1798,0.82,3,0,30,27,10.0,8.2
1799,0.804,4,0,26,22,10.0,8.04
1800,0.766,6,0,21,15,10.0,7.66
1801,0.88,2,0,23,21,10.0,8.8
1802,0.72,5,0,24,19,10.0,7.2
1803,0.795,4,0,24,20,10.0,7.95
1804,0.73,4,0,26,22,10.0,7.3
1805,0.815,3,0,30,27,10.0,8.15
1806,0.672,8,0,31,23,10.0,6.72
1807,0.712,7,0,25,18,10.0,7.12
1808,0.7,4,0,17,13,10.0,7.0
1809,0.816,4,0,30,26,10.0,8.16
1810,0.78,4,0,23,19,10.0,7.8
1811,0.808,4,0,32,28,10.0,8.08
1812,0.8,4,0,37,33,10.0,8.0
1813,0.754,5,0,23,18,10.0,7.54
1814,0.772,6,0,25,19,10.0,7.72
1815,0.876,2,0,22,20,10.0,8.76
1816,0.712,7,0,27,20,10.0,7.12
1817,0.784,4,0,27,23,10.0,7.84
1818,0.725,3,0,19,16,10.0,7.25
1819,0.896,2,0,28,26,10.0,8.96
1820,0.744,5,0,29,24,10.0,7.44
1821,0.828,3,0,28,25,10.0,8.28
1822,0.832,3,0,26,23,10.0,8.32
1823,0.678,8,0,30,22,10.0,6.78
1824,0.702,3,0,26,23,10.0,7.02
1825,0.756,6,0,36,30,10.0,7.56
1826,0.792,6,0,32,26,10.0,7.92
1827,0.69,6,0,28,22,10.0,6.9
1828,0.79,6,0,30,24,10.0,7.9
1829,0.66,4,0,21,17,10.0,6.6
1830,0.822,5,0,28,23,10.0,8.22
1831,0.79,5,0,35,30,10.0,7.9
1832,0.765,3,0,19,16,10.0,7.65
1833,0.82,7,0,36,29,10.0,8.2
1834,0.748,4,0,29,25,10.0,7.48
1835,0.82,7,0,35,28,10.0,8.2
1836,0.74,4,0,23,19,10.0,7.4
1837,0.696,7,0,27,20,10.0,6.96
1838,0.746,11,0,37,26,10.0,7.46
1839,0.76,3,0,17,14,10.0,7.6
1840,0.712,7,0,28,21,10.0,7.12
1841,0.72,4,0,21,17,10.0,7.2
1842,0.684,6,0,25,19,10.0,6.84
1843,0.768,4,0,32,28,10.0,7.68
1844,0.744,4,0,22,18,10.0,7.44
1845,0.84,2,0,20,18,10.0,8.4
1846,0.744,5,0,22,17,10.0,7.44
1847,0.696,6,0,26,20,10.0,6.96
1848,0.68,6,0,29,23,10.0,6.8
1849,0.925,1,0,12,11,10.0,9.25
1850,0.8,2,0,25,23,10.0,8.0
1851,0.75,2,0,15,13,10.0,7.5
1852,0.89,2,0,21,19,10.0,8.9
1853,0.705,3,0,25,22,10.0,7.05
1854,0.722,7,0,29,22,10.0,7.22
1855,0.808,4,0,28,24,10.0,8.08
1856,0.68,5,0,28,23,10.0,6.8
1857,0.658,6,0,25,19,10.0,6.58
1858,0.766,5,0,29,24,10.0,7.66
1859,0.744,6,0,33,27,10.0,7.44
1860,0.74,6,0,33,27,10.0,7.4
1861,0.784,5,0,29,24,10.0,7.84
1862,0.812,4,0,31,27,10.0,8.12
1863,0.832,4,0,32,28,10.0,8.32
1864,0.676,6,0,25,19,10.0,6.76
1865,0.84,3,0,25,22,10.0,8.4
1866,0.872,2,0,24,22,10.0,8.72
1867,0.828,3,0,28,25,10.0,8.28
1868,0.76,3,0,19,16,10.0,7.6
1869,0.73,6,0,25,19,10.0,7.3
1870,0.84,4,0,28,24,10.0,8.4
1871,0.78,3,0,25,22,10.0,7.8
1872,0.846,3,0,33,30,10.0,8.46
1873,0.701,7,0,29,22,10.0,7.01
1874,0.76,6,0,24,18,10.0,7.6
1875,0.8,3,0,22,19,10.0,8.0
1876,0.769,8,0,34,26,10.0,7.69
1877,0.78,4,0,18,14,10.0,7.8
1878,0.695,5,0,18,13,10.0,6.95
1879,0.86,4,0,28,24,10.0,8.6
1880,0.87,2,0,21,19,10.0,8.7
1881,0.795,4,0,35,31,10.0,7.95
1882,0.549,8,0,27,19,10.0,5.49
1883,0.68,13,0,37,24,10.0,6.8
1884,0.691,7,0,27,20,10.0,6.91
1885,0.744,5,0,24,19,10.0,7.44
1886,0.76,4,0,26,22,10.0,7.6
1887,0.78,4,0,28,24,10.0,7.8
1888,0.782,7,0,35,28,10.0,7.82
1889,0.792,5,0,30,25,10.0,7.92
1890,0.68,7,0,27,20,10.0,6.8
1891,0.84,4,0,22,18,10.0,8.4
1892,0.772,7,0,23,16,10.0,7.72
1893,0.68,4,0,29,25,10.0,6.8
1894,0.82,5,0,31,26,10.0,8.2
1895,0.752,6,0,35,29,10.0,7.52
1896,0.78,3,0,20,17,10.0,7.8
1897,0.76,3,0,21,18,10.0,7.6
1898,0.704,6,0,29,23,10.0,7.04
1899,0.732,6,0,34,28,10.0,7.32
1900,0.712,4,0,30,26,10.0,7.12
1901,0.784,5,0,28,23,10.0,7.84
1902,0.786,4,0,25,21,10.0,7.86
1903,0.792,4,0,25,21,10.0,7.92
1904,0.768,6,0,43,37,10.0,7.68
1905,0.68,5,0,20,15,10.0,6.8
1906,0.732,4,0,29,25,10.0,7.32
1907,0.86,2,0,22,20,10.0,8.6
1908,0.651,8,0,31,23,10.0,6.51
1909,0.76,4,0,23,19,10.0,7.6
1910,0.74,3,0,18,15,10.0,7.4
1911,0.716,4,0,26,22,10.0,7.16
1912,0.706,5,0,33,28,10.0,7.06
1913,0.665,5,0,16,11,10.0,6.65
1914,0.8,2,0,21,19,10.0,8.0
1915,0.699,5,0,33,28,10.0,6.99
1916,0.76,3,0,18,15,10.0,7.6
1917,0.804,3,0,24,21,10.0,8.04
1918,0.88,3,0,26,23,10.0,8.8
1919,0.635,5,0,25,20,10.0,6.35
1920,0.695,3,0,19,16,10.0,6.95
1921,0.704,6,0,28,22,10.0,7.04
1922,0.712,5,0,28,23,10.0,7.12
1923,0.688,6,0,31,25,10.0,6.88
1924,0.88,2,0,16,14,10.0,8.8
1925,0.712,6,0,32,26,10.0,7.12
1926,0.745,4,0,28,24,10.0,7.45
1927,0.824,3,0,28,25,10.0,8.24
1928,0.599,7,0,27,20,10.0,5.99
1929,0.761,5,0,31,26,10.0,7.61
1930,0.82,2,0,17,15,10.0,8.2
1931,0.8,2,0,16,14,10.0,8.0
1932,0.665,4,0,17,13,10.0,6.65
1933,0.776,4,0,30,26,10.0,7.76
1934,0.724,4,0,25,21,10.0,7.24
1935,0.728,8,0,36,28,10.0,7.28
1936,0.83,3,0,21,18,10.0,8.3
1937,0.725,3,0,18,15,10.0,7.25
1938,0.86,2,0,21,19,10.0,8.6
1939,0.672,5,0,22,17,10.0,6.72
1940,0.705,4,0,19,15,10.0,7.05
1941,0.74,6,0,26,20,10.0,7.4
1942,0.796,3,0,25,22,10.0,7.96
1943,0.818,5,0,36,31,10.0,8.18
1944,0.78,3,0,17,14,10.0,7.8
1945,0.65,5,0,21,16,10.0,6.5
1946,0.728,5,0,28,23,10.0,7.28
1947,0.683,5,0,33,28,10.0,6.83
1948,0.756,5,0,29,24,10.0,7.56
1949,0.64,10,0,27,17,10.0,6.4
1950,0.865,2,0,18,16,10.0,8.65
1951,0.774,5,0,28,23,10.0,7.74
1952,0.74,3,0,30,27,10.0,7.4
1953,0.82,2,0,23,21,10.0,8.2
1954,0.692,7,0,27,20,10.0,6.92
1955,0.82,6,0,34,28,10.0,8.2
1956,0.74,5,0,18,13,10.0,7.4
1957,0.82,3,0,22,19,10.0,8.2
1958,0.778,5,0,27,22,10.0,7.78
1959,0.752,5,0,32,27,10.0,7.52
1960,0.802,5,0,28,23,10.0,8.02
1961,0.74,4,0,18,14,10.0,7.4
1962,0.85,5,0,38,33,10.0,8.5
1963,0.692,6,0,24,18,10.0,6.92
1964,0.784,5,0,27,22,10.0,7.84
1965,0.826,4,0,21,17,10.0,8.26
1966,0.816,3,0,25,22,10.0,8.16
1967,0.642,7,0,24,17,10.0,6.42
1968,0.692,5,0,30,25,10.0,6.92
1969,0.72,5,0,24,19,10.0,7.2
1970,0.837,6,0,36,30,10.0,8.37
1971,0.704,6,0,28,22,10.0,7.04
1972,0.715,4,0,25,21,10.0,7.15
1973,0.63,4,0,23,19,10.0,6.3
1974,0.736,4,0,26,22,10.0,7.36
1975,0.732,6,0,28,22,10.0,7.32
1976,0.696,5,0,26,21,10.0,6.96
1977,0.798,6,0,33,27,10.0,7.98
1978,0.768,4,0,25,21,10.0,7.68
1979,0.76,3,0,17,14,10.0,7.6
1980,0.76,3,0,17,14,10.0,7.6
1981,0.86,4,0,40,36,10.0,8.6
1982,0.64,7,0,25,18,10.0,6.4
1983,0.814,5,0,27,22,10.0,8.14
1984,0.768,5,0,33,28,10.0,7.68
1985,0.636,6,0,27,21,10.0,6.36
1986,0.716,6,0,29,23,10.0,7.16
1987,0.84,2,0,20,18,10.0,8.4
1988,0.696,6,0,28,22,10.0,6.96
1989,0.72,5,0,27,22,10.0,7.2
1990,0.76,5,0,27,22,10.0,7.6
1991,0.8,3,0,26,23,10.0,8.0
1992,0.9,1,0,18,17,10.0,9.0
1993,0.742,5,0,29,24,10.0,7.42
1994,0.8,2,0,22,20,10.0,8.0
1995,0.764,5,0,30,25,10.0,7.64
1996,0.675,3,0,26,23,10.0,6.75
1997,0.73,6,0,29,23,10.0,7.3
1998,0.74,3,0,17,14,10.0,7.4
1999,0.742,6,0,27,21,10.0,7.42
2000,0.729,4,0,17,13,10.0,7.29
2001,0.736,6,0,28,22,10.0,7.36
2002,0.67,6,0,26,20,10.0,6.7
2003,0.832,7,0,31,24,10.0,8.32
2004,0.652,8,0,35,27,10.0,6.52
2005,0.718,5,0,30,25,10.0,7.18
2006,0.726,5,0,23,18,10.0,7.26
2007,0.639,7,0,25,18,10.0,6.39
2008,0.744,4,0,27,23,10.0,7.44
2009,0.76,4,0,24,20,10.0,7.6
2010,0.744,7,0,24,17,10.0,7.44
2011,0.612,9,0,30,21,10.0,6.12
2012,0.76,4,0,23,19,10.0,7.6
2013,0.637,8,0,27,19,10.0,6.37
2014,0.744,4,0,21,17,10.0,7.44
2015,0.76,5,0,30,25,10.0,7.6
2016,0.674,8,0,26,18,10.0,6.74
2017,0.756,6,0,30,24,10.0,7.56
2018,0.699,7,0,28,21,10.0,6.99
2019,0.738,5,0,27,22,10.0,7.38
2020,0.78,3,0,22,19,10.0,7.8
2021,0.75,2,0,14,12,10.0,7.5
2022,0.695,4,0,19,15,10.0,6.95
2023,0.72,9,0,36,27,10.0,7.2
2024,0.885,2,0,25,23,10.0,8.85
2025,0.81,4,0,28,24,10.0,8.1
2026,0.864,3,0,31,28,10.0,8.64
2027,0.826,3,0,28,25,10.0,8.26
2028,0.87,3,0,21,18,10.0,8.7
2029,0.788,9,0,36,27,10.0,7.88
2030,0.824,8,0,32,24,10.0,8.24
2031,0.746,4,0,26,22,10.0,7.46
2032,0.864,3,0,32,29,10.0,8.64
2033,0.796,6,0,34,28,10.0,7.96
2034,0.72,5,0,28,23,10.0,7.2
2035,0.722,10,0,35,25,10.0,7.22
2036,0.792,4,0,27,23,10.0,7.92
2037,0.808,3,0,28,25,10.0,8.08
2038,0.784,5,0,28,23,10.0,7.84
2039,0.632,7,0,28,21,10.0,6.32
2040,0.704,5,0,28,23,10.0,7.04
2041,0.74,5,0,30,25,10.0,7.4
2042,0.575,5,0,16,11,10.0,5.75
2043,0.8,3,0,15,12,10.0,8.0
2044,0.636,5,0,23,18,10.0,6.36
2045,0.805,3,0,19,16,10.0,8.05
2046,0.772,5,0,28,23,10.0,7.72
2047,0.696,6,0,33,27,10.0,6.96
2048,0.665,5,0,23,18,10.0,6.65
2049,0.825,2,0,14,12,10.0,8.25
2050,0.8,2,0,28,26,10.0,8.0
2051,0.798,4,0,24,20,10.0,7.98
2052,0.785,3,0,26,23,10.0,7.85
2053,0.776,5,0,26,21,10.0,7.76
2054,0.755,4,0,19,15,10.0,7.55
2055,0.814,4,0,30,26,10.0,8.14
2056,0.772,4,0,21,17,10.0,7.72
2057,0.704,5,0,26,21,10.0,7.04
2058,0.8,2,0,26,24,10.0,8.0
2059,0.872,4,0,30,26,10.0,8.72
2060,0.79,5,0,21,16,10.0,7.9
2061,0.829,5,0,34,29,10.0,8.29
2062,0.754,5,0,24,19,10.0,7.54
2063,0.656,8,0,32,24,10.0,6.56
2064,0.74,3,0,19,16,10.0,7.4
2065,0.736,3,0,19,16,10.0,7.36
2066,0.772,5,0,25,20,10.0,7.72
2067,0.73,4,0,23,19,10.0,7.3
2068,0.758,7,0,35,28,10.0,7.58
2069,0.728,6,0,29,23,10.0,7.28
2070,0.728,6,0,28,22,10.0,7.28
2071,0.774,4,0,29,25,10.0,7.74
2072,0.825,2,0,18,16,10.0,8.25
2073,0.744,5,0,29,24,10.0,7.44
2074,0.72,8,0,37,29,10.0,7.2
2075,0.728,7,0,28,21,10.0,7.28
2076,0.74,5,0,26,21,10.0,7.4
2077,0.784,6,0,27,21,10.0,7.84
2078,0.76,3,0,23,20,10.0,7.6
2079,0.744,7,0,28,21,10.0,7.44
2080,0.814,5,0,26,21,10.0,8.14
2081,0.776,5,0,30,25,10.0,7.76
2082,0.925,1,0,13,12,10.0,9.25
2083,0.678,6,0,28,22,10.0,6.78
2084,0.74,3,0,19,16,10.0,7.4
2085,0.682,6,0,33,27,10.0,6.82
2086,0.68,5,0,24,19,10.0,6.8
2087,0.664,8,0,27,19,10.0,6.64
2088,0.88,4,0,31,27,10.0,8.8
2089,0.875,2,0,15,13,10.0,8.75
2090,0.629,7,0,27,20,10.0,6.29
2091,0.736,5,0,29,24,10.0,7.36
2092,0.602,7,0,23,16,10.0,6.02
2093,0.74,5,0,21,16,10.0,7.4
2094,0.754,6,0,27,21,10.0,7.54
2095,0.74,5,0,23,18,10.0,7.4
2096,0.808,4,0,33,29,10.0,8.08
2097,0.76,5,0,26,21,10.0,7.6
2098,0.744,5,0,30,25,10.0,7.44
2099,0.68,4,0,22,18,10.0,6.8
2100,0.825,2,0,19,17,10.0,8.25
