episode,utilization,invalid_learned,invalid_attempted,boxes_attempted,placed_boxes,max_height,avg_height
1,0.771,7,0,26,19,10.0,7.71
2,0.905,3,0,20,17,10.0,9.05
3,0.89,4,0,27,23,10.0,8.9
4,0.823,5,0,36,31,10.0,8.23
5,0.818,5,0,24,19,10.0,8.18
6,0.709,7,0,24,17,10.0,7.09
7,0.737,12,0,36,24,10.0,7.37
8,0.613,8,0,24,16,10.0,6.13
9,0.793,5,0,29,24,10.0,7.93
10,0.8,3,0,17,14,10.0,8.0
11,0.836,6,0,35,29,10.0,8.36
12,0.9,2,0,19,17,10.0,9.0
13,0.755,4,0,16,12,10.0,7.55
14,0.78,5,0,25,20,10.0,7.8
15,0.748,6,0,31,25,10.0,7.48
16,0.768,6,0,28,22,10.0,7.68
17,0.77,4,0,19,15,10.0,7.7
18,0.75,3,0,12,9,10.0,7.5
19,0.67,9,0,31,22,10.0,6.7
20,0.644,7,0,30,23,10.0,6.44
21,0.8,4,0,36,32,10.0,8.0
22,0.765,4,0,19,15,10.0,7.65
23,0.855,3,0,17,14,10.0,8.55
24,0.636,10,0,30,20,10.0,6.36
25,0.627,6,0,30,24,10.0,6.27
26,0.701,6,0,26,20,10.0,7.01
27,0.702,7,0,31,24,10.0,7.02
28,0.815,4,0,28,24,10.0,8.15
29,0.775,6,0,27,21,10.0,7.75
30,0.78,5,0,31,26,10.0,7.8
31,0.808,6,0,37,31,10.0,8.08
32,0.67,8,0,27,19,10.0,6.7
33,0.75,5,0,18,13,10.0,7.5
34,0.76,6,0,33,27,10.0,7.6
35,0.822,6,0,28,22,10.0,8.22
36,0.694,7,0,24,17,10.0,6.94
37,0.71,4,0,30,26,10.0,7.1
38,0.752,7,0,36,29,10.0,7.52
39,0.704,8,0,34,26,10.0,7.04
40,0.736,8,0,26,18,10.0,7.36
41,0.757,6,0,28,22,10.0,7.57
42,0.82,3,0,21,18,10.0,8.2
43,0.794,5,0,32,27,10.0,7.94
44,0.692,5,0,30,25,10.0,6.92
45,0.78,4,0,26,22,10.0,7.8
46,0.694,8,0,28,20,10.0,6.94
47,0.7,6,0,25,19,10.0,7.0
48,0.712,7,0,27,20,10.0,7.12
49,0.62,8,0,26,18,10.0,6.2
50,0.752,7,0,29,22,10.0,7.52
51,0.688,9,0,30,21,10.0,6.88
52,0.818,5,0,32,27,10.0,8.18
53,0.68,8,0,28,20,10.0,6.8
54,0.856,5,0,29,24,10.0,8.56
55,0.765,5,0,24,19,10.0,7.65
56,0.848,6,0,40,34,10.0,8.48
57,0.718,8,0,26,18,10.0,7.18
58,0.71,8,0,32,24,10.0,7.1
59,0.764,15,0,47,32,10.0,7.64
60,0.766,6,0,26,20,10.0,7.66
61,0.855,3,0,15,12,10.0,8.55
62,0.66,6,0,25,19,10.0,6.6
63,0.805,5,0,32,27,10.0,8.05
64,0.72,5,0,23,18,10.0,7.2
65,0.668,6,0,22,16,10.0,6.68
66,0.748,6,0,29,23,10.0,7.48
67,0.78,4,0,26,22,10.0,7.8
68,0.641,7,0,25,18,10.0,6.41
69,0.648,7,0,27,20,10.0,6.48
70,0.714,6,0,29,23,10.0,7.14
71,0.7,8,0,29,21,10.0,7.0
72,0.752,6,0,27,21,10.0,7.52
73,0.78,4,0,28,24,10.0,7.8
74,0.782,5,0,35,30,10.0,7.82
75,0.711,7,0,27,20,10.0,7.11
76,0.84,3,0,21,18,10.0,8.4
77,0.714,6,0,25,19,10.0,7.14
78,0.72,5,0,26,21,10.0,7.2
79,0.77,5,0,21,16,10.0,7.7
80,0.811,5,0,27,22,10.0,8.11
81,0.82,4,0,29,25,10.0,8.2
82,0.84,3,0,29,26,10.0,8.4
83,0.765,5,0,29,24,10.0,7.65
84,0.724,6,0,26,20,10.0,7.24
85,0.591,8,0,26,18,10.0,5.91
86,0.712,5,0,20,15,10.0,7.12
87,0.688,8,0,30,22,10.0,6.88
88,0.617,9,0,31,22,10.0,6.17
89,0.676,8,0,28,20,10.0,6.76
90,0.81,4,0,23,19,10.0,8.1
91,0.756,5,0,28,23,10.0,7.56
92,0.624,7,0,27,20,10.0,6.24
93,0.705,8,0,31,23,10.0,7.05
94,0.665,5,0,25,20,10.0,6.65
95,0.875,2,0,16,14,10.0,8.75
96,0.736,7,0,34,27,10.0,7.36
97,0.772,6,0,31,25,10.0,7.72
98,0.76,4,0,18,14,10.0,7.6
99,0.83,6,0,34,28,10.0,8.3
100,0.75,5,0,28,23,10.0,7.5
101,0.756,5,0,28,23,10.0,7.56
102,0.79,6,0,33,27,10.0,7.9
103,0.716,8,0,38,30,10.0,7.16
104,0.83,4,0,24,20,10.0,8.3
105,0.731,10,0,31,21,10.0,7.31
106,0.62,6,0,16,10,10.0,6.2
107,0.65,6,0,20,14,10.0,6.5
108,0.68,5,0,19,14,10.0,6.8
109,0.668,6,0,27,21,10.0,6.68
110,0.764,6,0,31,25,10.0,7.64
111,0.752,6,0,39,33,10.0,7.52
112,0.764,5,0,37,32,10.0,7.64
113,0.708,9,0,34,25,10.0,7.08
114,0.796,6,0,31,25,10.0,7.96
115,0.679,10,0,28,18,10.0,6.79
116,0.805,4,0,31,27,10.0,8.05
117,0.92,2,0,32,30,10.0,9.2
118,0.875,5,0,27,22,10.0,8.75
119,0.8,3,0,19,16,10.0,8.0
120,0.745,7,0,21,14,10.0,7.45
121,0.744,7,0,34,27,10.0,7.44
122,0.765,4,0,31,27,10.0,7.65
123,0.82,3,0,32,29,10.0,8.2
124,0.729,5,0,26,21,10.0,7.29
125,0.75,9,0,42,33,10.0,7.5
126,0.704,6,0,28,22,10.0,7.04
127,0.612,9,0,30,21,10.0,6.12
128,0.776,6,0,30,24,10.0,7.76
129,0.784,5,0,27,22,10.0,7.84
130,0.7,6,0,26,20,10.0,7.0
131,0.784,5,0,31,26,10.0,7.84
132,0.744,7,0,27,20,10.0,7.44
133,0.808,4,0,27,23,10.0,8.08
134,0.789,4,0,26,22,10.0,7.89
135,0.799,5,0,30,25,10.0,7.99
136,0.78,4,0,19,15,10.0,7.8
137,0.695,6,0,31,25,10.0,6.95
138,0.696,7,0,26,19,10.0,6.96
139,0.768,5,0,28,23,10.0,7.68
140,0.754,6,0,29,23,10.0,7.54
141,0.794,5,0,30,25,10.0,7.94
142,0.66,7,0,29,22,10.0,6.6
143,0.724,12,0,44,32,10.0,7.24
144,0.816,6,0,37,31,10.0,8.16
145,0.638,6,0,19,13,10.0,6.38
146,0.748,7,0,35,28,10.0,7.48
147,0.7,4,0,23,19,10.0,7.0
148,0.678,7,0,27,20,10.0,6.78
149,0.768,8,0,35,27,10.0,7.68
150,0.688,7,0,27,20,10.0,6.88
151,0.789,6,0,31,25,10.0,7.89
152,0.69,4,0,18,14,10.0,6.9
153,0.762,5,0,30,25,10.0,7.62
154,0.76,5,0,25,20,10.0,7.6
155,0.75,7,0,41,34,10.0,7.5
156,0.805,4,0,22,18,10.0,8.05
157,0.74,5,0,19,14,10.0,7.4
158,0.756,5,0,28,23,10.0,7.56
159,0.765,4,0,22,18,10.0,7.65
160,0.878,5,0,30,25,10.0,8.78
161,0.726,6,0,29,23,10.0,7.26
162,0.797,7,0,27,20,10.0,7.97
163,0.766,6,0,29,23,10.0,7.66
164,0.745,4,0,18,14,10.0,7.45
165,0.772,6,0,26,20,10.0,7.72
166,0.85,5,0,36,31,10.0,8.5
167,0.705,5,0,29,24,10.0,7.05
168,0.744,6,0,32,26,10.0,7.44
169,0.84,4,0,30,26,10.0,8.4
170,0.704,6,0,25,19,10.0,7.04
171,0.735,5,0,19,14,10.0,7.35
172,0.84,3,0,31,28,10.0,8.4
173,0.76,6,0,35,29,10.0,7.6
174,0.692,7,0,27,20,10.0,6.92
175,0.672,7,0,31,24,10.0,6.72
176,0.776,5,0,24,19,10.0,7.76
177,0.828,5,0,32,27,10.0,8.28
178,0.796,6,0,31,25,10.0,7.96
179,0.719,6,0,28,22,10.0,7.19
180,0.716,6,0,28,22,10.0,7.16
181,0.746,6,0,27,21,10.0,7.46
182,0.71,5,0,19,14,10.0,7.1
183,0.875,2,0,28,26,10.0,8.75
184,0.672,8,0,30,22,10.0,6.72
185,0.846,4,0,29,25,10.0,8.46
186,0.734,9,0,40,31,10.0,7.34
187,0.731,6,0,27,21,10.0,7.31
188,0.689,7,0,32,25,10.0,6.89
189,0.832,5,0,25,20,10.0,8.32
190,0.793,5,0,26,21,10.0,7.93
191,0.756,6,0,32,26,10.0,7.56
192,0.76,4,0,26,22,10.0,7.6
193,0.69,4,0,27,23,10.0,6.9
194,0.808,5,0,36,31,10.0,8.08
195,0.667,10,0,33,23,10.0,6.67
196,0.78,4,0,19,15,10.0,7.8
197,0.752,6,0,28,22,10.0,7.52
198,0.806,5,0,29,24,10.0,8.06
199,0.684,6,0,31,25,10.0,6.84
200,0.745,4,0,25,21,10.0,7.45
201,0.802,4,0,30,26,10.0,8.02
202,0.74,8,0,37,29,10.0,7.4
203,0.68,6,0,22,16,10.0,6.8
204,0.86,3,0,24,21,10.0,8.6
205,0.664,10,0,35,25,10.0,6.64
206,0.724,7,0,28,21,10.0,7.24
207,0.737,6,0,31,25,10.0,7.37
208,0.729,7,0,28,21,10.0,7.29
209,0.786,6,0,32,26,10.0,7.86
210,0.77,5,0,29,24,10.0,7.7
211,0.766,6,0,38,32,10.0,7.66
212,0.712,6,0,28,22,10.0,7.12
213,0.72,7,0,28,21,10.0,7.2
214,0.666,7,0,24,17,10.0,6.66
215,0.8,6,0,36,30,10.0,8.0
216,0.722,6,0,31,25,10.0,7.22
217,0.86,3,0,25,22,10.0,8.6
218,0.696,7,0,26,19,10.0,6.96
219,0.76,5,0,24,19,10.0,7.6
220,0.792,4,0,28,24,10.0,7.92
221,0.628,7,0,25,18,10.0,6.28
222,0.782,9,0,36,27,10.0,7.82
223,0.8,6,0,34,28,10.0,8.0
224,0.708,6,0,28,22,10.0,7.08
225,0.66,5,0,24,19,10.0,6.6
226,0.767,5,0,35,30,10.0,7.67
227,0.7,4,0,18,14,10.0,7.0
228,0.675,6,0,24,18,10.0,6.75
229,0.742,5,0,26,21,10.0,7.42
230,0.71,6,0,21,15,10.0,7.1
231,0.76,5,0,29,24,10.0,7.6
232,0.712,7,0,30,23,10.0,7.12
233,0.8,4,0,19,15,10.0,8.0
234,0.796,5,0,31,26,10.0,7.96
235,0.712,6,0,29,23,10.0,7.12
236,0.735,5,0,23,18,10.0,7.35
237,0.55,5,0,20,15,10.0,5.5
238,0.664,7,0,26,19,10.0,6.64
239,0.8,4,0,30,26,10.0,8.0
240,0.716,6,0,33,27,10.0,7.16
241,0.74,6,0,30,24,10.0,7.4
242,0.715,5,0,21,16,10.0,7.15
243,0.816,5,0,27,22,10.0,8.16
244,0.724,7,0,24,17,10.0,7.24
245,0.785,4,0,20,16,10.0,7.85
246,0.696,6,0,30,24,10.0,6.96
247,0.662,7,0,28,21,10.0,6.62
248,0.745,5,0,23,18,10.0,7.45
249,0.714,5,0,24,19,10.0,7.14
250,0.874,5,0,37,32,10.0,8.74
251,0.669,8,0,30,22,10.0,6.69
252,0.648,8,0,27,19,10.0,6.48
253,0.638,8,0,27,19,10.0,6.38
254,0.788,5,0,28,23,10.0,7.88
255,0.769,7,0,28,21,10.0,7.69
256,0.655,6,0,19,13,10.0,6.55
257,0.671,7,0,28,21,10.0,6.71
258,0.636,8,0,26,18,10.0,6.36
259,0.74,4,0,27,23,10.0,7.4
260,0.8,3,0,18,15,10.0,8.0
261,0.724,7,0,29,22,10.0,7.24
262,0.776,5,0,26,21,10.0,7.76
263,0.61,8,0,23,15,10.0,6.1
264,0.872,3,0,23,20,10.0,8.72
265,0.768,5,0,29,24,10.0,7.68
266,0.704,9,0,31,22,10.0,7.04
267,0.832,5,0,28,23,10.0,8.32
268,0.744,6,0,30,24,10.0,7.44
269,0.841,4,0,25,21,10.0,8.41
270,0.756,5,0,29,24,10.0,7.56
271,0.77,6,0,40,34,10.0,7.7
272,0.811,5,0,28,23,10.0,8.11
273,0.84,4,0,26,22,10.0,8.4
274,0.776,6,0,30,24,10.0,7.76
275,0.65,5,0,20,15,10.0,6.5
276,0.82,3,0,24,21,10.0,8.2
277,0.644,7,0,27,20,10.0,6.44
278,0.76,4,0,26,22,10.0,7.6
279,0.745,6,0,19,13,10.0,7.45
280,0.638,7,0,22,15,10.0,6.38
281,0.752,7,0,33,26,10.0,7.52
282,0.825,3,0,19,16,10.0,8.25
283,0.528,10,0,25,15,10.0,5.28
284,0.792,6,0,30,24,10.0,7.92
285,0.725,5,0,21,16,10.0,7.25
286,0.864,5,0,32,27,10.0,8.64
287,0.673,6,0,27,21,10.0,6.73
288,0.78,4,0,21,17,10.0,7.8
289,0.776,5,0,28,23,10.0,7.76
290,0.716,6,0,30,24,10.0,7.16
291,0.764,5,0,27,22,10.0,7.64
292,0.649,7,0,30,23,10.0,6.49
293,0.825,3,0,23,20,10.0,8.25
294,0.893,3,0,21,18,10.0,8.93
295,0.75,4,0,18,14,10.0,7.5
296,0.754,5,0,23,18,10.0,7.54
297,0.7,6,0,23,17,10.0,7.0
298,0.72,5,0,25,20,10.0,7.2
299,0.755,4,0,24,20,10.0,7.55
300,0.74,10,0,39,29,10.0,7.4
301,0.859,5,0,32,27,10.0,8.59
302,0.852,4,0,33,29,10.0,8.52
303,0.824,6,0,44,38,10.0,8.24
304,0.812,5,0,27,22,10.0,8.12
305,0.799,6,0,22,16,10.0,7.99
306,0.664,6,0,23,17,10.0,6.64
307,0.78,6,0,29,23,10.0,7.8
308,0.598,10,0,25,15,10.0,5.98
309,0.829,4,0,27,23,10.0,8.29
310,0.749,7,0,32,25,10.0,7.49
311,0.675,5,0,19,14,10.0,6.75
312,0.875,4,0,22,18,10.0,8.75
313,0.664,8,0,25,17,10.0,6.64
314,0.78,4,0,21,17,10.0,7.8
315,0.812,5,0,27,22,10.0,8.12
316,0.586,9,0,26,17,10.0,5.86
317,0.8,3,0,22,19,10.0,8.0
318,0.66,5,0,21,16,10.0,6.6
319,0.856,4,0,34,30,10.0,8.56
320,0.748,6,0,28,22,10.0,7.48
321,0.785,6,0,35,29,10.0,7.85
322,0.782,6,0,29,23,10.0,7.82
323,0.675,5,0,28,23,10.0,6.75
324,0.713,9,0,34,25,10.0,7.13
325,0.736,6,0,25,19,10.0,7.36
326,0.844,4,0,23,19,10.0,8.44
327,0.76,4,0,22,18,10.0,7.6
328,0.692,6,0,21,15,10.0,6.92
329,0.75,5,0,17,12,10.0,7.5
330,0.72,4,0,24,20,10.0,7.2
331,0.82,4,0,32,28,10.0,8.2
332,0.79,4,0,18,14,10.0,7.9
333,0.86,3,0,22,19,10.0,8.6
334,0.785,4,0,29,25,10.0,7.85
335,0.761,7,0,30,23,10.0,7.61
336,0.853,4,0,25,21,10.0,8.53
337,0.845,3,0,18,15,10.0,8.45
338,0.712,5,0,28,23,10.0,7.12
339,0.781,5,0,25,20,10.0,7.81
340,0.78,4,0,21,17,10.0,7.8
341,0.848,6,0,38,32,10.0,8.48
342,0.748,9,0,30,21,10.0,7.48
343,0.692,5,0,30,25,10.0,6.92
344,0.86,4,0,31,27,10.0,8.6
345,0.733,6,0,25,19,10.0,7.33
346,0.736,8,0,32,24,10.0,7.36
347,0.675,4,0,26,22,10.0,6.75
348,0.728,6,0,25,19,10.0,7.28
349,0.664,6,0,24,18,10.0,6.64
350,0.776,7,0,35,28,10.0,7.76
351,0.776,6,0,28,22,10.0,7.76
352,0.66,6,0,31,25,10.0,6.6
353,0.679,8,0,23,15,10.0,6.79
354,0.765,5,0,23,18,10.0,7.65
355,0.76,4,0,19,15,10.0,7.6
356,0.768,8,0,26,18,10.0,7.68
357,0.676,7,0,29,22,10.0,6.76
358,0.84,3,0,19,16,10.0,8.4
359,0.76,4,0,17,13,10.0,7.6
360,0.92,2,0,19,17,10.0,9.2
361,0.73,11,0,37,26,10.0,7.3
362,0.8,3,0,24,21,10.0,8.0
363,0.79,5,0,28,23,10.0,7.9
364,0.704,6,0,28,22,10.0,7.04
365,0.752,5,0,29,24,10.0,7.52
366,0.904,3,0,26,23,10.0,9.04
367,0.762,6,0,26,20,10.0,7.62
368,0.74,4,0,19,15,10.0,7.4
369,0.745,4,0,19,15,10.0,7.45
370,0.799,7,0,25,18,10.0,7.99
371,0.755,5,0,21,16,10.0,7.55
372,0.784,7,0,38,31,10.0,7.84
373,0.701,7,0,28,21,10.0,7.01
374,0.656,6,0,23,17,10.0,6.56
375,0.65,7,0,31,24,10.0,6.5
376,0.665,7,0,26,19,10.0,6.65
377,0.804,9,0,38,29,10.0,8.04
378,0.742,6,0,30,24,10.0,7.42
379,0.872,3,0,30,27,10.0,8.72
380,0.84,3,0,20,17,10.0,8.4
381,0.86,3,0,19,16,10.0,8.6
382,0.69,8,0,27,19,10.0,6.9
383,0.76,5,0,22,17,10.0,7.6
384,0.695,5,0,19,14,10.0,6.95
385,0.74,7,0,33,26,10.0,7.4
386,0.805,4,0,25,21,10.0,8.05
387,0.74,5,0,23,18,10.0,7.4
388,0.707,6,0,29,23,10.0,7.07
389,0.62,6,0,32,26,10.0,6.2
390,0.66,6,0,28,22,10.0,6.6
391,0.687,9,0,29,20,10.0,6.87
392,0.767,6,0,27,21,10.0,7.67
393,0.674,6,0,25,19,10.0,6.74
394,0.814,6,0,32,26,10.0,8.14
395,0.75,4,0,19,15,10.0,7.5
396,0.67,5,0,21,16,10.0,6.7
397,0.822,5,0,30,25,10.0,8.22
398,0.82,3,0,18,15,10.0,8.2
399,0.815,4,0,26,22,10.0,8.15
400,0.725,4,0,26,22,10.0,7.25
401,0.856,5,0,28,23,10.0,8.56
402,0.785,5,0,28,23,10.0,7.85
403,0.736,6,0,27,21,10.0,7.36
404,0.7,6,0,25,19,10.0,7.0
405,0.775,4,0,17,13,10.0,7.75
406,0.765,4,0,23,19,10.0,7.65
407,0.744,8,0,31,23,10.0,7.44
408,0.86,3,0,27,24,10.0,8.6
409,0.625,4,0,15,11,10.0,6.25
410,0.74,5,0,28,23,10.0,7.4
411,0.672,8,0,26,18,10.0,6.72
412,0.584,9,0,28,19,10.0,5.84
413,0.736,7,0,30,23,10.0,7.36
414,0.77,6,0,22,16,10.0,7.7
415,0.66,5,0,18,13,10.0,6.6
416,0.8,7,0,21,14,10.0,8.0
417,0.78,5,0,26,21,10.0,7.8
418,0.697,8,0,26,18,10.0,6.97
419,0.69,5,0,22,17,10.0,6.9
420,0.736,6,0,30,24,10.0,7.36
421,0.724,9,0,25,16,10.0,7.24
422,0.742,5,0,28,23,10.0,7.42
423,0.858,5,0,32,27,10.0,8.58
424,0.784,6,0,37,31,10.0,7.84
425,0.864,5,0,37,32,10.0,8.64
426,0.68,7,0,31,24,10.0,6.8
427,0.746,5,0,28,23,10.0,7.46
428,0.74,4,0,17,13,10.0,7.4
429,0.648,9,0,28,19,10.0,6.48
430,0.832,5,0,29,24,10.0,8.32
431,0.675,4,0,13,9,10.0,6.75
432,0.772,4,0,25,21,10.0,7.72
433,0.673,7,0,27,20,10.0,6.73
434,0.765,5,0,25,20,10.0,7.65
435,0.541,13,0,28,15,10.0,5.41
436,0.616,6,0,30,24,10.0,6.16
437,0.768,7,0,27,20,10.0,7.68
438,0.82,3,0,30,27,10.0,8.2
439,0.738,6,0,30,24,10.0,7.38
440,0.828,5,0,38,33,10.0,8.28
441,0.762,6,0,35,29,10.0,7.62
442,0.695,6,0,28,22,10.0,6.95
443,0.69,6,0,28,22,10.0,6.9
444,0.76,5,0,31,26,10.0,7.6
445,0.81,5,0,35,30,10.0,8.1
446,0.68,5,0,24,19,10.0,6.8
447,0.664,6,0,30,24,10.0,6.64
448,0.658,6,0,27,21,10.0,6.58
449,0.772,6,0,36,30,10.0,7.72
450,0.76,5,0,24,19,10.0,7.6
451,0.713,6,0,22,16,10.0,7.13
452,0.679,8,0,37,29,10.0,6.79
453,0.73,6,0,29,23,10.0,7.3
454,0.817,7,0,32,25,10.0,8.17
455,0.815,4,0,26,22,10.0,8.15
456,0.776,7,0,35,28,10.0,7.76
457,0.74,4,0,20,16,10.0,7.4
458,0.78,4,0,31,27,10.0,7.8
459,0.652,8,0,30,22,10.0,6.52
460,0.726,8,0,31,23,10.0,7.26
461,0.682,8,0,31,23,10.0,6.82
462,0.712,6,0,28,22,10.0,7.12
463,0.68,7,0,26,19,10.0,6.8
464,0.754,5,0,29,24,10.0,7.54
465,0.7,5,0,17,12,10.0,7.0
466,0.764,4,0,22,18,10.0,7.64
467,0.745,8,0,34,26,10.0,7.45
468,0.657,6,0,24,18,10.0,6.57
469,0.752,6,0,30,24,10.0,7.52
470,0.84,4,0,32,28,10.0,8.4
471,0.751,4,0,24,20,10.0,7.51
472,0.82,4,0,25,21,10.0,8.2
473,0.666,6,0,27,21,10.0,6.66
474,0.74,5,0,29,24,10.0,7.4
475,0.72,5,0,25,20,10.0,7.2
476,0.736,7,0,30,23,10.0,7.36
477,0.715,5,0,19,14,10.0,7.15
478,0.68,7,0,32,25,10.0,6.8
479,0.717,10,0,42,32,10.0,7.17
480,0.688,8,0,28,20,10.0,6.88
481,0.721,7,0,26,19,10.0,7.21
482,0.8,5,0,28,23,10.0,8.0
483,0.61,7,0,27,20,10.0,6.1
484,0.796,5,0,32,27,10.0,7.96
485,0.756,7,0,28,21,10.0,7.56
486,0.736,6,0,31,25,10.0,7.36
487,0.675,5,0,20,15,10.0,6.75
488,0.732,6,0,32,26,10.0,7.32
489,0.66,6,0,31,25,10.0,6.6
490,0.825,3,0,15,12,10.0,8.25
491,0.684,7,0,32,25,10.0,6.84
492,0.72,10,0,34,24,10.0,7.2
493,0.744,7,0,31,24,10.0,7.44
494,0.724,6,0,27,21,10.0,7.24
495,0.76,4,0,17,13,10.0,7.6
496,0.75,3,0,14,11,10.0,7.5
497,0.752,6,0,33,27,10.0,7.52
498,0.816,4,0,30,26,10.0,8.16
499,0.736,8,0,25,17,10.0,7.36
500,0.72,7,0,28,21,10.0,7.2
501,0.678,6,0,26,20,10.0,6.78
502,0.738,6,0,30,24,10.0,7.38
503,0.775,5,0,27,22,10.0,7.75
504,0.811,7,0,24,17,10.0,8.11
505,0.64,5,0,21,16,10.0,6.4
506,0.79,6,0,26,20,10.0,7.9
507,0.74,4,0,27,23,10.0,7.4
508,0.8,5,0,28,23,10.0,8.0
509,0.772,4,0,27,23,10.0,7.72
510,0.78,5,0,29,24,10.0,7.8
511,0.616,8,0,26,18,10.0,6.16
512,0.725,5,0,20,15,10.0,7.25
513,0.724,6,0,29,23,10.0,7.24
514,0.86,4,0,24,20,10.0,8.6
515,0.718,7,0,27,20,10.0,7.18
516,0.812,4,0,28,24,10.0,8.12
517,0.792,5,0,29,24,10.0,7.92
518,0.675,4,0,21,17,10.0,6.75
519,0.79,7,0,31,24,10.0,7.9
520,0.756,6,0,33,27,10.0,7.56
521,0.78,6,0,33,27,10.0,7.8
522,0.72,5,0,28,23,10.0,7.2
523,0.75,7,0,26,19,10.0,7.5
524,0.68,6,0,27,21,10.0,6.8
525,0.74,4,0,22,18,10.0,7.4
526,0.848,5,0,31,26,10.0,8.48
527,0.662,9,0,34,25,10.0,6.62
528,0.82,4,0,26,22,10.0,8.2
529,0.82,5,0,31,26,10.0,8.2
530,0.855,3,0,21,18,10.0,8.55
531,0.838,5,0,38,33,10.0,8.38
532,0.747,6,0,32,26,10.0,7.47
533,0.78,4,0,33,29,10.0,7.8
534,0.648,10,0,31,21,10.0,6.48
535,0.7,6,0,27,21,10.0,7.0
536,0.828,4,0,25,21,10.0,8.28
537,0.835,4,0,28,24,10.0,8.35
538,0.72,6,0,29,23,10.0,7.2
539,0.716,7,0,29,22,10.0,7.16
540,0.68,5,0,18,13,10.0,6.8
541,0.81,5,0,29,24,10.0,8.1
542,0.711,7,0,27,20,10.0,7.11
543,0.698,8,0,27,19,10.0,6.98
544,0.725,4,0,25,21,10.0,7.25
545,0.812,8,0,34,26,10.0,8.12
546,0.745,5,0,27,22,10.0,7.45
547,0.692,10,0,34,24,10.0,6.92
548,0.681,7,0,29,22,10.0,6.81
549,0.8,5,0,27,22,10.0,8.0
550,0.814,5,0,25,20,10.0,8.14
551,0.69,9,0,33,24,10.0,6.9
552,0.631,8,0,25,17,10.0,6.31
553,0.74,4,0,28,24,10.0,7.4
554,0.82,5,0,31,26,10.0,8.2
555,0.75,3,0,18,15,10.0,7.5
556,0.756,6,0,33,27,10.0,7.56
557,0.825,3,0,16,13,10.0,8.25
558,0.804,5,0,28,23,10.0,8.04
559,0.781,5,0,27,22,10.0,7.81
560,0.812,6,0,34,28,10.0,8.12
561,0.708,6,0,29,23,10.0,7.08
562,0.748,6,0,32,26,10.0,7.48
563,0.768,6,0,30,24,10.0,7.68
564,0.684,7,0,29,22,10.0,6.84
565,0.67,5,0,19,14,10.0,6.7
566,0.76,5,0,28,23,10.0,7.6
567,0.792,4,0,32,28,10.0,7.92
568,0.71,5,0,23,18,10.0,7.1
569,0.82,3,0,26,23,10.0,8.2
570,0.758,7,0,26,19,10.0,7.58
571,0.7,4,0,20,16,10.0,7.0
572,0.8,3,0,14,11,10.0,8.0
573,0.812,4,0,29,25,10.0,8.12
574,0.681,8,0,28,20,10.0,6.81
575,0.775,5,0,29,24,10.0,7.75
576,0.904,4,0,27,23,10.0,9.04
577,0.846,4,0,26,22,10.0,8.46
578,0.8,3,0,22,19,10.0,8.0
579,0.764,7,0,38,31,10.0,7.64
580,0.872,4,0,27,23,10.0,8.72
581,0.72,5,0,20,15,10.0,7.2
582,0.792,4,0,25,21,10.0,7.92
583,0.634,8,0,30,22,10.0,6.34
584,0.84,4,0,31,27,10.0,8.4
585,0.77,4,0,27,23,10.0,7.7
586,0.675,4,0,25,21,10.0,6.75
587,0.775,5,0,37,32,10.0,7.75
588,0.81,7,0,31,24,10.0,8.1
589,0.776,4,0,26,22,10.0,7.76
590,0.832,5,0,32,27,10.0,8.32
591,0.632,7,0,29,22,10.0,6.32
592,0.684,7,0,26,19,10.0,6.84
593,0.752,7,0,34,27,10.0,7.52
594,0.635,6,0,33,27,10.0,6.35
595,0.832,4,0,29,25,10.0,8.32
596,0.725,6,0,28,22,10.0,7.25
597,0.8,6,0,35,29,10.0,8.0
598,0.802,4,0,25,21,10.0,8.02
599,0.787,6,0,27,21,10.0,7.87
600,0.78,4,0,25,21,10.0,7.8
601,0.85,3,0,17,14,10.0,8.5
602,0.748,6,0,25,19,10.0,7.48
603,0.643,6,0,23,17,10.0,6.43
604,0.727,6,0,27,21,10.0,7.27
605,0.715,8,0,28,20,10.0,7.15
606,0.71,12,0,34,22,10.0,7.1
607,0.712,6,0,28,22,10.0,7.12
608,0.841,5,0,29,24,10.0,8.41
609,0.739,5,0,30,25,10.0,7.39
610,0.7,6,0,20,14,10.0,7.0
611,0.712,6,0,26,20,10.0,7.12
612,0.62,6,0,25,19,10.0,6.2
613,0.795,4,0,17,13,10.0,7.95
614,0.682,9,0,38,29,10.0,6.82
615,0.781,5,0,28,23,10.0,7.81
616,0.865,3,0,21,18,10.0,8.65
617,0.685,7,0,29,22,10.0,6.85
618,0.768,5,0,26,21,10.0,7.68
619,0.6,7,0,33,26,10.0,6.0
620,0.716,6,0,28,22,10.0,7.16
621,0.861,4,0,23,19,10.0,8.61
622,0.752,5,0,26,21,10.0,7.52
623,0.78,4,0,21,17,10.0,7.8
624,0.745,6,0,24,18,10.0,7.45
625,0.816,4,0,26,22,10.0,8.16
626,0.742,7,0,29,22,10.0,7.42
627,0.84,3,0,19,16,10.0,8.4
628,0.66,6,0,25,19,10.0,6.6
629,0.675,4,0,20,16,10.0,6.75
630,0.826,5,0,28,23,10.0,8.26
631,0.794,6,0,31,25,10.0,7.94
632,0.78,6,0,32,26,10.0,7.8
633,0.7,6,0,25,19,10.0,7.0
634,0.764,6,0,32,26,10.0,7.64
635,0.8,4,0,21,17,10.0,8.0
636,0.848,4,0,32,28,10.0,8.48
637,0.792,5,0,31,26,10.0,7.92
638,0.75,4,0,18,14,10.0,7.5
639,0.84,4,0,30,26,10.0,8.4
640,0.724,6,0,32,26,10.0,7.24
641,0.67,5,0,26,21,10.0,6.7
642,0.72,7,0,28,21,10.0,7.2
643,0.74,4,0,17,13,10.0,7.4
644,0.632,7,0,28,21,10.0,6.32
645,0.791,5,0,33,28,10.0,7.91
646,0.808,4,0,31,27,10.0,8.08
647,0.704,6,0,28,22,10.0,7.04
648,0.668,8,0,21,13,10.0,6.68
649,0.7,6,0,26,20,10.0,7.0
650,0.797,6,0,30,24,10.0,7.97
651,0.84,4,0,29,25,10.0,8.4
652,0.832,4,0,29,25,10.0,8.32
653,0.766,6,0,27,21,10.0,7.66
654,0.768,5,0,29,24,10.0,7.68
655,0.676,9,0,33,24,10.0,6.76
656,0.75,5,0,30,25,10.0,7.5
657,0.75,6,0,29,23,10.0,7.5
658,0.796,6,0,28,22,10.0,7.96
659,0.694,9,0,30,21,10.0,6.94
660,0.733,8,0,35,27,10.0,7.33
661,0.71,5,0,35,30,10.0,7.1
662,0.765,4,0,25,21,10.0,7.65
663,0.825,3,0,16,13,10.0,8.25
664,0.816,6,0,36,30,10.0,8.16
665,0.835,4,0,25,21,10.0,8.35
666,0.74,5,0,21,16,10.0,7.4
667,0.772,6,0,30,24,10.0,7.72
668,0.728,6,0,29,23,10.0,7.28
669,0.74,4,0,17,13,10.0,7.4
670,0.692,7,0,28,21,10.0,6.92
671,0.808,5,0,39,34,10.0,8.08
672,0.7,6,0,25,19,10.0,7.0
673,0.78,4,0,22,18,10.0,7.8
674,0.805,4,0,20,16,10.0,8.05
675,0.83,3,0,19,16,10.0,8.3
676,0.748,8,0,41,33,10.0,7.48
677,0.824,4,0,35,31,10.0,8.24
678,0.736,5,0,26,21,10.0,7.36
679,0.766,6,0,25,19,10.0,7.66
680,0.828,5,0,26,21,10.0,8.28
681,0.8,3,0,15,12,10.0,8.0
682,0.805,7,0,26,19,10.0,8.05
683,0.775,3,0,14,11,10.0,7.75
684,0.802,7,0,39,32,10.0,8.02
685,0.76,4,0,26,22,10.0,7.6
686,0.73,5,0,20,15,10.0,7.3
687,0.775,3,0,20,17,10.0,7.75
688,0.78,6,0,27,21,10.0,7.8
689,0.693,7,0,28,21,10.0,6.93
690,0.684,8,0,26,18,10.0,6.84
691,0.63,9,0,31,22,10.0,6.3
692,0.848,4,0,26,22,10.0,8.48
693,0.715,4,0,22,18,10.0,7.15
694,0.81,4,0,19,15,10.0,8.1
695,0.74,5,0,28,23,10.0,7.4
696,0.707,6,0,30,24,10.0,7.07
697,0.713,7,0,30,23,10.0,7.13
698,0.756,5,0,23,18,10.0,7.56
699,0.8,3,0,22,19,10.0,8.0
700,0.713,6,0,28,22,10.0,7.13
701,0.758,6,0,26,20,10.0,7.58
702,0.72,7,0,31,24,10.0,7.2
703,0.7,4,0,17,13,10.0,7.0
704,0.737,5,0,30,25,10.0,7.37
705,0.75,6,0,31,25,10.0,7.5
706,0.78,4,0,24,20,10.0,7.8
707,0.73,7,0,28,21,10.0,7.3
708,0.745,5,0,29,24,10.0,7.45
709,0.768,6,0,28,22,10.0,7.68
710,0.68,5,0,17,12,10.0,6.8
711,0.765,5,0,27,22,10.0,7.65
712,0.725,4,0,26,22,10.0,7.25
713,0.736,4,0,27,23,10.0,7.36
714,0.758,5,0,32,27,10.0,7.58
715,0.9,3,0,36,33,10.0,9.0
716,0.76,5,0,32,27,10.0,7.6
717,0.726,6,0,28,22,10.0,7.26
718,0.716,6,0,25,19,10.0,7.16
719,0.66,7,0,27,20,10.0,6.6
720,0.644,7,0,26,19,10.0,6.44
721,0.748,7,0,30,23,10.0,7.48
722,0.616,8,0,28,20,10.0,6.16
723,0.8,5,0,30,25,10.0,8.0
724,0.744,6,0,29,23,10.0,7.44
725,0.72,5,0,20,15,10.0,7.2
726,0.661,7,0,26,19,10.0,6.61
727,0.792,4,0,29,25,10.0,7.92
728,0.696,7,0,33,26,10.0,6.96
729,0.712,5,0,22,17,10.0,7.12
730,0.764,5,0,31,26,10.0,7.64
731,0.872,4,0,36,32,10.0,8.72
732,0.645,6,0,18,12,10.0,6.45
733,0.758,5,0,27,22,10.0,7.58
734,0.717,6,0,29,23,10.0,7.17
735,0.8,3,0,31,28,10.0,8.0
736,0.71,5,0,28,23,10.0,7.1
737,0.75,3,0,15,12,10.0,7.5
738,0.848,5,0,28,23,10.0,8.48
739,0.696,6,0,28,22,10.0,6.96
740,0.65,4,0,19,15,10.0,6.5
741,0.669,6,0,29,23,10.0,6.69
742,0.876,4,0,24,20,10.0,8.76
743,0.74,6,0,26,20,10.0,7.4
744,0.736,7,0,29,22,10.0,7.36
745,0.676,6,0,20,14,10.0,6.76
746,0.72,6,0,29,23,10.0,7.2
747,0.824,5,0,37,32,10.0,8.24
748,0.854,4,0,35,31,10.0,8.54
749,0.7,5,0,22,17,10.0,7.0
750,0.77,4,0,19,15,10.0,7.7
751,0.6,6,0,28,22,10.0,6.0
752,0.76,4,0,17,13,10.0,7.6
753,0.756,5,0,35,30,10.0,7.56
754,0.71,5,0,33,28,10.0,7.1
755,0.74,6,0,29,23,10.0,7.4
756,0.84,4,0,23,19,10.0,8.4
757,0.784,6,0,32,26,10.0,7.84
758,0.805,5,0,36,31,10.0,8.05
759,0.74,4,0,29,25,10.0,7.4
760,0.787,5,0,24,19,10.0,7.87
761,0.783,5,0,26,21,10.0,7.83
762,0.86,3,0,28,25,10.0,8.6
763,0.708,9,0,36,27,10.0,7.08
764,0.704,6,0,27,21,10.0,7.04
765,0.75,4,0,20,16,10.0,7.5
766,0.639,8,0,27,19,10.0,6.39
767,0.808,5,0,23,18,10.0,8.08
768,0.8,3,0,34,31,10.0,8.0
769,0.76,5,0,25,20,10.0,7.6
770,0.845,3,0,20,17,10.0,8.45
771,0.736,7,0,32,25,10.0,7.36
772,0.752,6,0,35,29,10.0,7.52
773,0.72,4,0,24,20,10.0,7.2
774,0.8,4,0,27,23,10.0,8.0
775,0.533,9,0,26,17,10.0,5.33
776,0.76,6,0,30,24,10.0,7.6
777,0.769,5,0,31,26,10.0,7.69
778,0.725,4,0,17,13,10.0,7.25
779,0.856,3,0,28,25,10.0,8.56
780,0.76,6,0,37,31,10.0,7.6
781,0.807,5,0,34,29,10.0,8.07
782,0.792,6,0,32,26,10.0,7.92
783,0.788,5,0,29,24,10.0,7.88
784,0.81,6,0,37,31,10.0,8.1
785,0.732,10,0,30,20,10.0,7.32
786,0.68,6,0,19,13,10.0,6.8
787,0.835,4,0,21,17,10.0,8.35
788,0.769,5,0,27,22,10.0,7.69
789,0.675,4,0,17,13,10.0,6.75
790,0.724,5,0,32,27,10.0,7.24
791,0.806,6,0,27,21,10.0,8.06
792,0.819,5,0,33,28,10.0,8.19
793,0.728,6,0,25,19,10.0,7.28
794,0.78,4,0,20,16,10.0,7.8
795,0.715,7,0,28,21,10.0,7.15
796,0.84,7,0,22,15,10.0,8.4
797,0.804,4,0,35,31,10.0,8.04
798,0.784,6,0,38,32,10.0,7.84
799,0.65,5,0,22,17,10.0,6.5
800,0.774,5,0,28,23,10.0,7.74
801,0.792,5,0,29,24,10.0,7.92
802,0.775,4,0,17,13,10.0,7.75
803,0.624,7,0,24,17,10.0,6.24
804,0.763,8,0,33,25,10.0,7.63
805,0.668,7,0,28,21,10.0,6.68
806,0.837,4,0,22,18,10.0,8.37
807,0.704,7,0,31,24,10.0,7.04
808,0.815,7,0,40,33,10.0,8.15
809,0.784,6,0,31,25,10.0,7.84
810,0.664,6,0,29,23,10.0,6.64
811,0.675,5,0,23,18,10.0,6.75
812,0.808,4,0,28,24,10.0,8.08
813,0.7,4,0,17,13,10.0,7.0
814,0.66,7,0,22,15,10.0,6.6
815,0.742,7,0,28,21,10.0,7.42
816,0.68,7,0,27,20,10.0,6.8
817,0.786,6,0,28,22,10.0,7.86
818,0.726,7,0,31,24,10.0,7.26
819,0.75,5,0,16,11,10.0,7.5
820,0.706,8,0,36,28,10.0,7.06
821,0.756,6,0,29,23,10.0,7.56
822,0.636,8,0,28,20,10.0,6.36
823,0.758,6,0,29,23,10.0,7.58
824,0.785,4,0,23,19,10.0,7.85
825,0.716,5,0,27,22,10.0,7.16
826,0.612,8,0,29,21,10.0,6.12
827,0.7,5,0,25,20,10.0,7.0
828,0.744,6,0,28,22,10.0,7.44
829,0.84,3,0,29,26,10.0,8.4
830,0.685,8,0,29,21,10.0,6.85
831,0.696,6,0,31,25,10.0,6.96
832,0.815,6,0,27,21,10.0,8.15
833,0.718,5,0,26,21,10.0,7.18
834,0.764,6,0,29,23,10.0,7.64
835,0.764,5,0,28,23,10.0,7.64
836,0.789,4,0,29,25,10.0,7.89
837,0.88,4,0,25,21,10.0,8.8
838,0.654,8,0,27,19,10.0,6.54
839,0.7,4,0,22,18,10.0,7.0
840,0.674,8,0,28,20,10.0,6.74
841,0.72,5,0,22,17,10.0,7.2
842,0.776,6,0,25,19,10.0,7.76
843,0.78,4,0,21,17,10.0,7.8
844,0.774,10,0,36,26,10.0,7.74
845,0.696,6,0,27,21,10.0,6.96
846,0.676,8,0,30,22,10.0,6.76
847,0.753,6,0,29,23,10.0,7.53
848,0.804,6,0,28,22,10.0,8.04
849,0.725,4,0,19,15,10.0,7.25
850,0.813,4,0,27,23,10.0,8.13
851,0.76,7,0,33,26,10.0,7.6
852,0.733,5,0,24,19,10.0,7.33
853,0.805,7,0,36,29,10.0,8.05
854,0.755,6,0,20,14,10.0,7.55
855,0.713,7,0,25,18,10.0,7.13
856,0.692,6,0,29,23,10.0,6.92
857,0.816,5,0,26,21,10.0,8.16
858,0.78,5,0,21,16,10.0,7.8
859,0.725,4,0,22,18,10.0,7.25
860,0.795,4,0,22,18,10.0,7.95
861,0.685,6,0,19,13,10.0,6.85
862,0.818,7,0,28,21,10.0,8.18
863,0.709,7,0,28,21,10.0,7.09
864,0.912,3,0,42,39,10.0,9.12
865,0.8,3,0,20,17,10.0,8.0
866,0.82,4,0,26,22,10.0,8.2
867,0.744,10,0,40,30,10.0,7.44
868,0.644,8,0,28,20,10.0,6.44
869,0.78,4,0,31,27,10.0,7.8
870,0.778,5,0,27,22,10.0,7.78
871,0.693,8,0,30,22,10.0,6.93
872,0.73,7,0,30,23,10.0,7.3
873,0.83,6,0,32,26,10.0,8.3
874,0.63,6,0,33,27,10.0,6.3
875,0.725,5,0,30,25,10.0,7.25
876,0.724,6,0,29,23,10.0,7.24
877,0.805,4,0,22,18,10.0,8.05
878,0.826,5,0,26,21,10.0,8.26
879,0.73,8,0,32,24,10.0,7.3
880,0.83,4,0,21,17,10.0,8.3
881,0.68,5,0,21,16,10.0,6.8
882,0.767,5,0,23,18,10.0,7.67
883,0.682,9,0,27,18,10.0,6.82
884,0.765,6,0,34,28,10.0,7.65
885,0.748,5,0,21,16,10.0,7.48
886,0.78,4,0,20,16,10.0,7.8
887,0.716,5,0,25,20,10.0,7.16
888,0.728,7,0,29,22,10.0,7.28
889,0.625,5,0,14,9,10.0,6.25
890,0.799,5,0,33,28,10.0,7.99
891,0.65,9,0,25,16,10.0,6.5
892,0.795,4,0,19,15,10.0,7.95
893,0.774,5,0,30,25,10.0,7.74
894,0.792,6,0,29,23,10.0,7.92
895,0.796,9,0,34,25,10.0,7.96
896,0.764,7,0,25,18,10.0,7.64
897,0.723,6,0,20,14,10.0,7.23
898,0.76,4,0,26,22,10.0,7.6
899,0.644,6,0,24,18,10.0,6.44
900,0.779,8,0,37,29,10.0,7.79
901,0.822,4,0,31,27,10.0,8.22
902,0.732,6,0,30,24,10.0,7.32
903,0.788,7,0,43,36,10.0,7.88
904,0.841,4,0,25,21,10.0,8.41
905,0.76,4,0,21,17,10.0,7.6
906,0.655,6,0,26,20,10.0,6.55
907,0.754,7,0,34,27,10.0,7.54
908,0.719,6,0,31,25,10.0,7.19
909,0.746,6,0,27,21,10.0,7.46
910,0.675,4,0,16,12,10.0,6.75
911,0.774,6,0,31,25,10.0,7.74
912,0.875,2,0,14,12,10.0,8.75
913,0.846,5,0,30,25,10.0,8.46
914,0.672,8,0,33,25,10.0,6.72
915,0.645,5,0,17,12,10.0,6.45
916,0.68,7,0,29,22,10.0,6.8
917,0.732,6,0,29,23,10.0,7.32
918,0.645,6,0,23,17,10.0,6.45
919,0.756,6,0,31,25,10.0,7.56
920,0.82,6,0,29,23,10.0,8.2
921,0.736,6,0,26,20,10.0,7.36
922,0.848,5,0,31,26,10.0,8.48
923,0.82,5,0,39,34,10.0,8.2
924,0.83,4,0,18,14,10.0,8.3
925,0.735,5,0,29,24,10.0,7.35
926,0.68,5,0,29,24,10.0,6.8
927,0.785,4,0,21,17,10.0,7.85
928,0.616,10,0,38,28,10.0,6.16
929,0.744,5,0,29,24,10.0,7.44
930,0.76,6,0,33,27,10.0,7.6
931,0.793,8,0,28,20,10.0,7.93
932,0.65,6,0,26,20,10.0,6.5
933,0.568,8,0,22,14,10.0,5.68
934,0.731,6,0,32,26,10.0,7.31
935,0.737,8,0,31,23,10.0,7.37
936,0.8,4,0,27,23,10.0,8.0
937,0.748,5,0,27,22,10.0,7.48
938,0.679,11,0,29,18,10.0,6.79
939,0.765,4,0,18,14,10.0,7.65
940,0.76,5,0,19,14,10.0,7.6
941,0.74,5,0,27,22,10.0,7.4
942,0.712,6,0,29,23,10.0,7.12
943,0.776,4,0,30,26,10.0,7.76
944,0.726,8,0,30,22,10.0,7.26
945,0.735,5,0,27,22,10.0,7.35
946,0.772,6,0,30,24,10.0,7.72
947,0.648,9,0,29,20,10.0,6.48
948,0.68,6,0,25,19,10.0,6.8
949,0.72,7,0,31,24,10.0,7.2
950,0.836,5,0,33,28,10.0,8.36
951,0.84,3,0,20,17,10.0,8.4
952,0.792,6,0,31,25,10.0,7.92
953,0.68,7,0,28,21,10.0,6.8
954,0.736,6,0,21,15,10.0,7.36
955,0.79,5,0,20,15,10.0,7.9
956,0.715,8,0,27,19,10.0,7.15
957,0.792,5,0,27,22,10.0,7.92
958,0.804,5,0,30,25,10.0,8.04
959,0.676,6,0,26,20,10.0,6.76
960,0.792,5,0,26,21,10.0,7.92
961,0.624,7,0,28,21,10.0,6.24
962,0.75,3,0,17,14,10.0,7.5
963,0.872,3,0,25,22,10.0,8.72
964,0.692,6,0,29,23,10.0,6.92
965,0.825,3,0,19,16,10.0,8.25
966,0.7,8,0,33,25,10.0,7.0
967,0.8,4,0,20,16,10.0,8.0
968,0.78,4,0,24,20,10.0,7.8
969,0.733,5,0,23,18,10.0,7.33
970,0.84,5,0,42,37,10.0,8.4
971,0.862,5,0,32,27,10.0,8.62
972,0.744,5,0,24,19,10.0,7.44
973,0.824,6,0,35,29,10.0,8.24
974,0.652,6,0,32,26,10.0,6.52
975,0.718,6,0,28,22,10.0,7.18
976,0.905,5,0,30,25,10.0,9.05
977,0.764,5,0,25,20,10.0,7.64
978,0.77,5,0,25,20,10.0,7.7
979,0.634,8,0,24,16,10.0,6.34
980,0.7,8,0,28,20,10.0,7.0
981,0.752,8,0,29,21,10.0,7.52
982,0.74,4,0,20,16,10.0,7.4
983,0.732,5,0,26,21,10.0,7.32
984,0.656,8,0,27,19,10.0,6.56
985,0.674,12,0,36,24,10.0,6.74
986,0.75,3,0,15,12,10.0,7.5
987,0.78,5,0,26,21,10.0,7.8
988,0.804,6,0,24,18,10.0,8.04
989,0.732,5,0,27,22,10.0,7.32
990,0.912,5,0,23,18,10.0,9.12
991,0.8,3,0,29,26,10.0,8.0
992,0.856,4,0,28,24,10.0,8.56
993,0.56,7,0,24,17,10.0,5.6
994,0.826,6,0,24,18,10.0,8.26
995,0.768,5,0,24,19,10.0,7.68
996,0.696,6,0,32,26,10.0,6.96
997,0.84,4,0,32,28,10.0,8.4
998,0.728,6,0,27,21,10.0,7.28
999,0.738,7,0,31,24,10.0,7.38
1000,0.69,5,0,31,26,10.0,6.9
1001,0.78,5,0,28,23,10.0,7.8
1002,0.816,4,0,27,23,10.0,8.16
1003,0.724,6,0,30,24,10.0,7.24
1004,0.82,3,0,20,17,10.0,8.2
1005,0.856,5,0,36,31,10.0,8.56
1006,0.615,5,0,17,12,10.0,6.15
1007,0.724,5,0,29,24,10.0,7.24
1008,0.752,4,0,20,16,10.0,7.52
1009,0.75,3,0,17,14,10.0,7.5
1010,0.766,6,0,29,23,10.0,7.66
1011,0.8,5,0,32,27,10.0,8.0
1012,0.72,5,0,22,17,10.0,7.2
1013,0.8,6,0,19,13,10.0,8.0
1014,0.68,5,0,22,17,10.0,6.8
1015,0.692,8,0,38,30,10.0,6.92
1016,0.744,5,0,26,21,10.0,7.44
1017,0.795,4,0,16,12,10.0,7.95
1018,0.628,9,0,26,17,10.0,6.28
1019,0.748,5,0,23,18,10.0,7.48
1020,0.668,7,0,22,15,10.0,6.68
1021,0.622,8,0,26,18,10.0,6.22
1022,0.739,5,0,31,26,10.0,7.39
1023,0.755,5,0,23,18,10.0,7.55
1024,0.776,5,0,25,20,10.0,7.76
1025,0.78,4,0,22,18,10.0,7.8
1026,0.725,5,0,19,14,10.0,7.25
1027,0.778,8,0,31,23,10.0,7.78
1028,0.79,4,0,21,17,10.0,7.9
1029,0.726,5,0,24,19,10.0,7.26
1030,0.84,3,0,18,15,10.0,8.4
1031,0.72,7,0,38,31,10.0,7.2
1032,0.754,7,0,34,27,10.0,7.54
1033,0.752,7,0,34,27,10.0,7.52
1034,0.649,7,0,28,21,10.0,6.49
1035,0.704,7,0,27,20,10.0,7.04
1036,0.796,5,0,30,25,10.0,7.96
1037,0.84,3,0,24,21,10.0,8.4
1038,0.844,4,0,33,29,10.0,8.44
1039,0.67,7,0,26,19,10.0,6.7
1040,0.762,5,0,30,25,10.0,7.62
1041,0.74,5,0,27,22,10.0,7.4
1042,0.753,6,0,26,20,10.0,7.53
1043,0.64,6,0,26,20,10.0,6.4
1044,0.756,5,0,27,22,10.0,7.56
1045,0.81,4,0,21,17,10.0,8.1
1046,0.751,6,0,31,25,10.0,7.51
1047,0.734,6,0,26,20,10.0,7.34
1048,0.72,6,0,23,17,10.0,7.2
1049,0.848,4,0,28,24,10.0,8.48
1050,0.78,4,0,19,15,10.0,7.8
1051,0.82,4,0,26,22,10.0,8.2
1052,0.784,5,0,26,21,10.0,7.84
1053,0.758,5,0,25,20,10.0,7.58
1054,0.74,6,0,28,22,10.0,7.4
1055,0.61,6,0,19,13,10.0,6.1
1056,0.89,3,0,24,21,10.0,8.9
1057,0.72,4,0,18,14,10.0,7.2
1058,0.693,7,0,26,19,10.0,6.93
1059,0.624,7,0,28,21,10.0,6.24
1060,0.8,3,0,13,10,10.0,8.0
1061,0.55,6,0,25,19,10.0,5.5
1062,0.72,8,0,28,20,10.0,7.2
1063,0.84,3,0,35,32,10.0,8.4
1064,0.72,8,0,30,22,10.0,7.2
1065,0.716,7,0,31,24,10.0,7.16
1066,0.815,3,0,20,17,10.0,8.15
1067,0.76,7,0,35,28,10.0,7.6
1068,0.68,6,0,30,24,10.0,6.8
1069,0.766,6,0,30,24,10.0,7.66
1070,0.793,6,0,26,20,10.0,7.93
1071,0.639,6,0,23,17,10.0,6.39
1072,0.62,7,0,26,19,10.0,6.2
1073,0.788,7,0,30,23,10.0,7.88
1074,0.664,9,0,36,27,10.0,6.64
1075,0.7,6,0,20,14,10.0,7.0
1076,0.628,10,0,27,17,10.0,6.28
1077,0.625,4,0,16,12,10.0,6.25
1078,0.76,5,0,29,24,10.0,7.6
1079,0.8,3,0,28,25,10.0,8.0
1080,0.844,4,0,27,23,10.0,8.44
1081,0.588,8,0,26,18,10.0,5.88
1082,0.688,8,0,29,21,10.0,6.88
1083,0.8,3,0,30,27,10.0,8.0
1084,0.84,4,0,19,15,10.0,8.4
1085,0.842,6,0,33,27,10.0,8.42
1086,0.675,6,0,26,20,10.0,6.75
1087,0.723,5,0,23,18,10.0,7.23
1088,0.734,8,0,37,29,10.0,7.34
1089,0.665,5,0,18,13,10.0,6.65
1090,0.825,3,0,14,11,10.0,8.25
1091,0.732,8,0,35,27,10.0,7.32
1092,0.72,7,0,33,26,10.0,7.2
1093,0.75,5,0,30,25,10.0,7.5
1094,0.8,5,0,30,25,10.0,8.0
1095,0.824,4,0,28,24,10.0,8.24
1096,0.7,5,0,21,16,10.0,7.0
1097,0.699,9,0,32,23,10.0,6.99
1098,0.7,4,0,15,11,10.0,7.0
1099,0.732,6,0,28,22,10.0,7.32
1100,0.88,5,0,34,29,10.0,8.8
1101,0.765,4,0,32,28,10.0,7.65
1102,0.744,6,0,32,26,10.0,7.44
1103,0.81,4,0,27,23,10.0,8.1
1104,0.696,7,0,32,25,10.0,6.96
1105,0.664,7,0,29,22,10.0,6.64
1106,0.735,4,0,23,19,10.0,7.35
1107,0.692,7,0,24,17,10.0,6.92
1108,0.738,6,0,22,16,10.0,7.38
1109,0.68,8,0,30,22,10.0,6.8
1110,0.823,5,0,30,25,10.0,8.23
1111,0.724,5,0,26,21,10.0,7.24
1112,0.678,7,0,24,17,10.0,6.78
1113,0.856,4,0,38,34,10.0,8.56
1114,0.786,4,0,29,25,10.0,7.86
1115,0.64,5,0,19,14,10.0,6.4
1116,0.728,5,0,29,24,10.0,7.28
1117,0.72,6,0,26,20,10.0,7.2
1118,0.613,9,0,29,20,10.0,6.13
1119,0.628,8,0,25,17,10.0,6.28
1120,0.622,7,0,28,21,10.0,6.22
1121,0.629,8,0,28,20,10.0,6.29
1122,0.84,3,0,21,18,10.0,8.4
1123,0.682,10,0,35,25,10.0,6.82
1124,0.652,6,0,29,23,10.0,6.52
1125,0.712,5,0,26,21,10.0,7.12
1126,0.712,7,0,30,23,10.0,7.12
1127,0.714,12,0,37,25,10.0,7.14
1128,0.802,5,0,36,31,10.0,8.02
1129,0.895,3,0,15,12,10.0,8.95
1130,0.716,6,0,28,22,10.0,7.16
1131,0.695,4,0,26,22,10.0,6.95
1132,0.82,4,0,29,25,10.0,8.2
1133,0.8,3,0,24,21,10.0,8.0
1134,0.72,5,0,21,16,10.0,7.2
1135,0.765,5,0,29,24,10.0,7.65
1136,0.94,2,0,17,15,10.0,9.4
1137,0.737,9,0,29,20,10.0,7.37
1138,0.78,4,0,18,14,10.0,7.8
1139,0.683,7,0,26,19,10.0,6.83
1140,0.688,10,0,36,26,10.0,6.88
1141,0.77,4,0,20,16,10.0,7.7
1142,0.736,6,0,36,30,10.0,7.36
1143,0.708,7,0,32,25,10.0,7.08
1144,0.712,6,0,24,18,10.0,7.12
1145,0.736,6,0,30,24,10.0,7.36
1146,0.815,6,0,24,18,10.0,8.15
1147,0.856,5,0,37,32,10.0,8.56
1148,0.712,10,0,41,31,10.0,7.12
1149,0.784,6,0,31,25,10.0,7.84
1150,0.65,7,0,24,17,10.0,6.5
1151,0.698,8,0,27,19,10.0,6.98
1152,0.72,5,0,25,20,10.0,7.2
1153,0.62,6,0,20,14,10.0,6.2
1154,0.728,6,0,30,24,10.0,7.28
1155,0.808,4,0,29,25,10.0,8.08
1156,0.776,5,0,29,24,10.0,7.76
1157,0.768,5,0,27,22,10.0,7.68
1158,0.784,6,0,27,21,10.0,7.84
1159,0.699,6,0,28,22,10.0,6.99
1160,0.736,7,0,32,25,10.0,7.36
1161,0.688,7,0,30,23,10.0,6.88
1162,0.8,3,0,17,14,10.0,8.0
1163,0.784,6,0,30,24,10.0,7.84
1164,0.92,2,0,16,14,10.0,9.2
1165,0.88,3,0,24,21,10.0,8.8
1166,0.656,7,0,26,19,10.0,6.56
1167,0.76,4,0,33,29,10.0,7.6
1168,0.74,5,0,29,24,10.0,7.4
1169,0.736,6,0,31,25,10.0,7.36
1170,0.684,6,0,29,23,10.0,6.84
1171,0.76,6,0,29,23,10.0,7.6
1172,0.835,4,0,22,18,10.0,8.35
1173,0.696,8,0,28,20,10.0,6.96
1174,0.68,6,0,19,13,10.0,6.8
1175,0.793,6,0,32,26,10.0,7.93
1176,0.65,5,0,14,9,10.0,6.5
1177,0.75,4,0,20,16,10.0,7.5
1178,0.738,9,0,35,26,10.0,7.38
1179,0.808,5,0,32,27,10.0,8.08
1180,0.756,8,0,30,22,10.0,7.56
1181,0.79,4,0,20,16,10.0,7.9
1182,0.648,7,0,28,21,10.0,6.48
1183,0.732,5,0,27,22,10.0,7.32
1184,0.81,4,0,27,23,10.0,8.1
1185,0.743,6,0,27,21,10.0,7.43
1186,0.735,7,0,29,22,10.0,7.35
1187,0.52,7,0,23,16,10.0,5.2
1188,0.752,8,0,34,26,10.0,7.52
1189,0.76,5,0,22,17,10.0,7.6
1190,0.74,5,0,19,14,10.0,7.4
1191,0.72,8,0,27,19,10.0,7.2
1192,0.8,3,0,20,17,10.0,8.0
1193,0.74,6,0,29,23,10.0,7.4
1194,0.84,4,0,25,21,10.0,8.4
1195,0.84,4,0,23,19,10.0,8.4
1196,0.786,8,0,34,26,10.0,7.86
1197,0.825,3,0,20,17,10.0,8.25
1198,0.768,7,0,39,32,10.0,7.68
1199,0.845,4,0,25,21,10.0,8.45
1200,0.76,6,0,29,23,10.0,7.6
1201,0.72,7,0,30,23,10.0,7.2
1202,0.78,5,0,35,30,10.0,7.8
1203,0.675,5,0,17,12,10.0,6.75
1204,0.836,3,0,30,27,10.0,8.36
1205,0.785,10,0,33,23,10.0,7.85
1206,0.84,3,0,19,16,10.0,8.4
1207,0.758,10,0,30,20,10.0,7.58
1208,0.674,6,0,26,20,10.0,6.74
1209,0.785,4,0,27,23,10.0,7.85
1210,0.73,6,0,30,24,10.0,7.3
1211,0.748,5,0,27,22,10.0,7.48
1212,0.778,7,0,30,23,10.0,7.78
1213,0.674,6,0,30,24,10.0,6.74
1214,0.765,4,0,25,21,10.0,7.65
1215,0.605,6,0,21,15,10.0,6.05
1216,0.752,6,0,27,21,10.0,7.52
1217,0.78,5,0,29,24,10.0,7.8
1218,0.712,7,0,26,19,10.0,7.12
1219,0.72,4,0,18,14,10.0,7.2
1220,0.832,5,0,25,20,10.0,8.32
1221,0.792,5,0,32,27,10.0,7.92
1222,0.842,6,0,29,23,10.0,8.42
1223,0.688,7,0,31,24,10.0,6.88
1224,0.7,5,0,28,23,10.0,7.0
1225,0.656,9,0,30,21,10.0,6.56
1226,0.761,5,0,37,32,10.0,7.61
1227,0.816,8,0,36,28,10.0,8.16
1228,0.808,4,0,26,22,10.0,8.08
1229,0.808,5,0,33,28,10.0,8.08
1230,0.85,4,0,16,12,10.0,8.5
1231,0.778,5,0,36,31,10.0,7.78
1232,0.752,5,0,27,22,10.0,7.52
1233,0.815,4,0,21,17,10.0,8.15
1234,0.688,8,0,32,24,10.0,6.88
1235,0.657,7,0,25,18,10.0,6.57
1236,0.81,4,0,27,23,10.0,8.1
1237,0.704,6,0,29,23,10.0,7.04
1238,0.748,5,0,28,23,10.0,7.48
1239,0.78,4,0,29,25,10.0,7.8
1240,0.7,4,0,25,21,10.0,7.0
1241,0.808,4,0,34,30,10.0,8.08
1242,0.764,8,0,41,33,10.0,7.64
1243,0.74,9,0,31,22,10.0,7.4
1244,0.725,5,0,19,14,10.0,7.25
1245,0.752,7,0,37,30,10.0,7.52
1246,0.755,5,0,32,27,10.0,7.55
1247,0.9,2,0,17,15,10.0,9.0
1248,0.82,3,0,29,26,10.0,8.2
1249,0.66,5,0,18,13,10.0,6.6
1250,0.733,5,0,27,22,10.0,7.33
1251,0.67,7,0,18,11,10.0,6.7
1252,0.814,5,0,31,26,10.0,8.14
1253,0.749,6,0,31,25,10.0,7.49
1254,0.753,6,0,29,23,10.0,7.53
1255,0.64,6,0,27,21,10.0,6.4
1256,0.757,5,0,22,17,10.0,7.57
1257,0.86,3,0,32,29,10.0,8.6
1258,0.719,7,0,21,14,10.0,7.19
1259,0.74,4,0,19,15,10.0,7.4
1260,0.723,7,0,27,20,10.0,7.23
1261,0.84,3,0,32,29,10.0,8.4
1262,0.72,5,0,23,18,10.0,7.2
1263,0.789,7,0,32,25,10.0,7.89
1264,0.75,3,0,18,15,10.0,7.5
1265,0.712,6,0,31,25,10.0,7.12
1266,0.625,5,0,16,11,10.0,6.25
1267,0.8,4,0,30,26,10.0,8.0
1268,0.845,3,0,18,15,10.0,8.45
1269,0.62,6,0,19,13,10.0,6.2
1270,0.762,6,0,39,33,10.0,7.62
1271,0.67,9,0,27,18,10.0,6.7
1272,0.864,4,0,33,29,10.0,8.64
1273,0.81,4,0,19,15,10.0,8.1
1274,0.88,3,0,20,17,10.0,8.8
1275,0.828,5,0,29,24,10.0,8.28
1276,0.72,6,0,24,18,10.0,7.2
1277,0.66,6,0,26,20,10.0,6.6
1278,0.7,4,0,18,14,10.0,7.0
1279,0.712,6,0,28,22,10.0,7.12
1280,0.88,3,0,25,22,10.0,8.8
1281,0.695,6,0,20,14,10.0,6.95
1282,0.68,5,0,22,17,10.0,6.8
1283,0.714,6,0,28,22,10.0,7.14
1284,0.712,6,0,34,28,10.0,7.12
1285,0.78,4,0,20,16,10.0,7.8
1286,0.698,7,0,27,20,10.0,6.98
1287,0.711,6,0,29,23,10.0,7.11
1288,0.832,4,0,23,19,10.0,8.32
1289,0.704,6,0,31,25,10.0,7.04
1290,0.789,5,0,27,22,10.0,7.89
1291,0.572,10,0,29,19,10.0,5.72
1292,0.815,4,0,19,15,10.0,8.15
1293,0.644,6,0,25,19,10.0,6.44
1294,0.625,8,0,23,15,10.0,6.25
1295,0.668,9,0,31,22,10.0,6.68
1296,0.617,8,0,28,20,10.0,6.17
1297,0.72,5,0,23,18,10.0,7.2
1298,0.78,4,0,23,19,10.0,7.8
1299,0.776,4,0,26,22,10.0,7.76
1300,0.788,4,0,35,31,10.0,7.88
1301,0.712,7,0,28,21,10.0,7.12
1302,0.772,5,0,32,27,10.0,7.72
1303,0.84,3,0,21,18,10.0,8.4
1304,0.83,5,0,26,21,10.0,8.3
1305,0.89,3,0,22,19,10.0,8.9
1306,0.76,4,0,29,25,10.0,7.6
1307,0.854,5,0,27,22,10.0,8.54
1308,0.776,4,0,29,25,10.0,7.76
1309,0.695,4,0,16,12,10.0,6.95
1310,0.8,4,0,30,26,10.0,8.0
1311,0.82,3,0,23,20,10.0,8.2
1312,0.725,6,0,29,23,10.0,7.25
1313,0.85,4,0,19,15,10.0,8.5
1314,0.865,3,0,16,13,10.0,8.65
1315,0.75,5,0,25,20,10.0,7.5
1316,0.751,6,0,25,19,10.0,7.51
1317,0.668,8,0,32,24,10.0,6.68
1318,0.848,4,0,22,18,10.0,8.48
1319,0.717,5,0,29,24,10.0,7.17
1320,0.781,7,0,27,20,10.0,7.81
1321,0.704,6,0,28,22,10.0,7.04
1322,0.767,8,0,42,34,10.0,7.67
1323,0.786,6,0,25,19,10.0,7.86
1324,0.703,6,0,31,25,10.0,7.03
1325,0.776,5,0,38,33,10.0,7.76
1326,0.784,4,0,25,21,10.0,7.84
1327,0.9,3,0,21,18,10.0,9.0
1328,0.719,5,0,27,22,10.0,7.19
1329,0.7,4,0,15,11,10.0,7.0
1330,0.708,6,0,27,21,10.0,7.08
1331,0.696,7,0,28,21,10.0,6.96
1332,0.85,3,0,29,26,10.0,8.5
1333,0.796,5,0,28,23,10.0,7.96
1334,0.648,7,0,23,16,10.0,6.48
1335,0.765,4,0,20,16,10.0,7.65
1336,0.728,6,0,31,25,10.0,7.28
1337,0.768,7,0,27,20,10.0,7.68
1338,0.74,4,0,20,16,10.0,7.4
1339,0.709,7,0,29,22,10.0,7.09
1340,0.681,7,0,28,21,10.0,6.81
1341,0.768,5,0,23,18,10.0,7.68
1342,0.68,7,0,30,23,10.0,6.8
1343,0.757,7,0,34,27,10.0,7.57
1344,0.745,7,0,30,23,10.0,7.45
1345,0.768,6,0,30,24,10.0,7.68
1346,0.82,4,0,19,15,10.0,8.2
1347,0.74,5,0,21,16,10.0,7.4
1348,0.68,5,0,29,24,10.0,6.8
1349,0.875,2,0,11,9,10.0,8.75
1350,0.717,5,0,26,21,10.0,7.17
1351,0.72,5,0,26,21,10.0,7.2
1352,0.778,6,0,28,22,10.0,7.78
1353,0.79,4,0,21,17,10.0,7.9
1354,0.884,3,0,38,35,10.0,8.84
1355,0.74,7,0,28,21,10.0,7.4
1356,0.765,6,0,30,24,10.0,7.65
1357,0.692,6,0,23,17,10.0,6.92
1358,0.685,7,0,26,19,10.0,6.85
1359,0.72,8,0,32,24,10.0,7.2
1360,0.752,8,0,36,28,10.0,7.52
1361,0.85,5,0,27,22,10.0,8.5
1362,0.81,4,0,35,31,10.0,8.1
1363,0.885,3,0,28,25,10.0,8.85
1364,0.76,4,0,26,22,10.0,7.6
1365,0.712,6,0,25,19,10.0,7.12
1366,0.675,7,0,26,19,10.0,6.75
1367,0.695,7,0,30,23,10.0,6.95
1368,0.76,5,0,19,14,10.0,7.6
1369,0.788,5,0,25,20,10.0,7.88
1370,0.835,4,0,29,25,10.0,8.35
1371,0.856,4,0,31,27,10.0,8.56
1372,0.684,7,0,27,20,10.0,6.84
1373,0.732,6,0,30,24,10.0,7.32
1374,0.66,8,0,29,21,10.0,6.6
1375,0.8,4,0,26,22,10.0,8.0
1376,0.711,7,0,29,22,10.0,7.11
1377,0.76,4,0,21,17,10.0,7.6
1378,0.811,5,0,35,30,10.0,8.11
1379,0.8,3,0,26,23,10.0,8.0
1380,0.72,7,0,28,21,10.0,7.2
1381,0.888,5,0,29,24,10.0,8.88
1382,0.872,5,0,37,32,10.0,8.72
1383,0.764,6,0,35,29,10.0,7.64
1384,0.69,6,0,24,18,10.0,6.9
1385,0.676,6,0,27,21,10.0,6.76
1386,0.79,4,0,31,27,10.0,7.9
1387,0.875,2,0,17,15,10.0,8.75
1388,0.788,6,0,30,24,10.0,7.88
1389,0.605,9,0,29,20,10.0,6.05
1390,0.74,4,0,23,19,10.0,7.4
1391,0.69,5,0,22,17,10.0,6.9
1392,0.82,5,0,28,23,10.0,8.2
1393,0.734,7,0,31,24,10.0,7.34
1394,0.722,7,0,34,27,10.0,7.22
1395,0.772,7,0,28,21,10.0,7.72
1396,0.79,5,0,28,23,10.0,7.9
1397,0.744,6,0,28,22,10.0,7.44
1398,0.715,6,0,23,17,10.0,7.15
1399,0.712,5,0,33,28,10.0,7.12
1400,0.734,6,0,26,20,10.0,7.34
1401,0.715,4,0,25,21,10.0,7.15
1402,0.653,7,0,28,21,10.0,6.53
1403,0.744,6,0,25,19,10.0,7.44
1404,0.784,6,0,30,24,10.0,7.84
1405,0.741,7,0,33,26,10.0,7.41
1406,0.764,5,0,28,23,10.0,7.64
1407,0.678,10,0,40,30,10.0,6.78
1408,0.8,4,0,22,18,10.0,8.0
1409,0.779,4,0,32,28,10.0,7.79
1410,0.664,9,0,41,32,10.0,6.64
1411,0.623,9,0,29,20,10.0,6.23
1412,0.8,4,0,24,20,10.0,8.0
1413,0.76,6,0,43,37,10.0,7.6
1414,0.732,6,0,25,19,10.0,7.32
1415,0.805,6,0,28,22,10.0,8.05
1416,0.616,8,0,33,25,10.0,6.16
1417,0.728,5,0,29,24,10.0,7.28
1418,0.828,4,0,30,26,10.0,8.28
1419,0.676,8,0,26,18,10.0,6.76
1420,0.82,4,0,27,23,10.0,8.2
1421,0.772,6,0,27,21,10.0,7.72
1422,0.783,6,0,30,24,10.0,7.83
1423,0.554,10,0,30,20,10.0,5.54
1424,0.82,5,0,29,24,10.0,8.2
1425,0.79,5,0,18,13,10.0,7.9
1426,0.82,3,0,22,19,10.0,8.2
1427,0.712,7,0,26,19,10.0,7.12
1428,0.84,3,0,19,16,10.0,8.4
1429,0.724,6,0,36,30,10.0,7.24
1430,0.69,6,0,29,23,10.0,6.9
1431,0.7,5,0,29,24,10.0,7.0
1432,0.762,7,0,35,28,10.0,7.62
1433,0.728,10,0,31,21,10.0,7.28
1434,0.88,3,0,16,13,10.0,8.8
1435,0.585,8,0,27,19,10.0,5.85
1436,0.632,6,0,27,21,10.0,6.32
1437,0.755,4,0,26,22,10.0,7.55
1438,0.69,6,0,28,22,10.0,6.9
1439,0.784,8,0,30,22,10.0,7.84
1440,0.705,5,0,21,16,10.0,7.05
1441,0.824,5,0,25,20,10.0,8.24
1442,0.81,4,0,19,15,10.0,8.1
1443,0.71,6,0,26,20,10.0,7.1
1444,0.804,4,0,24,20,10.0,8.04
1445,0.744,8,0,32,24,10.0,7.44
1446,0.744,7,0,28,21,10.0,7.44
1447,0.825,4,0,23,19,10.0,8.25
1448,0.736,6,0,32,26,10.0,7.36
1449,0.84,4,0,29,25,10.0,8.4
1450,0.712,5,0,22,17,10.0,7.12
1451,0.808,4,0,26,22,10.0,8.08
1452,0.636,9,0,29,20,10.0,6.36
1453,0.709,7,0,25,18,10.0,7.09
1454,0.776,5,0,34,29,10.0,7.76
1455,0.8,3,0,19,16,10.0,8.0
1456,0.716,6,0,24,18,10.0,7.16
1457,0.834,5,0,35,30,10.0,8.34
1458,0.715,7,0,33,26,10.0,7.15
1459,0.627,8,0,24,16,10.0,6.27
1460,0.774,8,0,31,23,10.0,7.74
1461,0.79,5,0,19,14,10.0,7.9
1462,0.744,6,0,28,22,10.0,7.44
1463,0.692,8,0,30,22,10.0,6.92
1464,0.795,4,0,26,22,10.0,7.95
1465,0.718,6,0,37,31,10.0,7.18
1466,0.768,6,0,26,20,10.0,7.68
1467,0.82,3,0,18,15,10.0,8.2
1468,0.692,5,0,25,20,10.0,6.92
1469,0.662,6,0,25,19,10.0,6.62
1470,0.815,8,0,33,25,10.0,8.15
1471,0.78,4,0,24,20,10.0,7.8
1472,0.795,4,0,19,15,10.0,7.95
1473,0.691,7,0,32,25,10.0,6.91
1474,0.785,5,0,28,23,10.0,7.85
1475,0.652,9,0,26,17,10.0,6.52
1476,0.804,6,0,29,23,10.0,8.04
1477,0.74,5,0,19,14,10.0,7.4
1478,0.74,5,0,36,31,10.0,7.4
1479,0.705,5,0,21,16,10.0,7.05
1480,0.81,4,0,21,17,10.0,8.1
1481,0.678,8,0,25,17,10.0,6.78
1482,0.755,4,0,22,18,10.0,7.55
1483,0.76,7,0,30,23,10.0,7.6
1484,0.724,6,0,29,23,10.0,7.24
1485,0.8,3,0,19,16,10.0,8.0
1486,0.84,3,0,19,16,10.0,8.4
1487,0.682,8,0,29,21,10.0,6.82
1488,0.792,6,0,37,31,10.0,7.92
1489,0.736,6,0,36,30,10.0,7.36
1490,0.781,6,0,27,21,10.0,7.81
1491,0.727,7,0,32,25,10.0,7.27
1492,0.675,4,0,26,22,10.0,6.75
1493,0.706,10,0,43,33,10.0,7.06
1494,0.728,6,0,35,29,10.0,7.28
1495,0.779,5,0,29,24,10.0,7.79
1496,0.694,6,0,22,16,10.0,6.94
1497,0.624,7,0,23,16,10.0,6.24
1498,0.695,5,0,19,14,10.0,6.95
1499,0.769,5,0,32,27,10.0,7.69
1500,0.8,3,0,27,24,10.0,8.0
1501,0.82,4,0,27,23,10.0,8.2
1502,0.636,8,0,31,23,10.0,6.36
1503,0.727,6,0,26,20,10.0,7.27
1504,0.759,6,0,29,23,10.0,7.59
1505,0.875,3,0,25,22,10.0,8.75
1506,0.792,5,0,32,27,10.0,7.92
1507,0.737,6,0,28,22,10.0,7.37
1508,0.684,6,0,31,25,10.0,6.84
1509,0.7,5,0,19,14,10.0,7.0
1510,0.68,7,0,28,21,10.0,6.8
1511,0.644,7,0,22,15,10.0,6.44
1512,0.683,6,0,28,22,10.0,6.83
1513,0.798,6,0,26,20,10.0,7.98
1514,0.764,5,0,30,25,10.0,7.64
1515,0.75,4,0,24,20,10.0,7.5
1516,0.714,9,0,32,23,10.0,7.14
1517,0.742,7,0,33,26,10.0,7.42
1518,0.752,6,0,34,28,10.0,7.52
1519,0.675,4,0,17,13,10.0,6.75
1520,0.709,6,0,22,16,10.0,7.09
1521,0.83,3,0,18,15,10.0,8.3
1522,0.79,4,0,20,16,10.0,7.9
1523,0.815,5,0,26,21,10.0,8.15
1524,0.68,5,0,33,28,10.0,6.8
1525,0.815,3,0,18,15,10.0,8.15
1526,0.8,3,0,17,14,10.0,8.0
1527,0.675,5,0,18,13,10.0,6.75
1528,0.8,3,0,27,24,10.0,8.0
1529,0.695,5,0,20,15,10.0,6.95
1530,0.672,6,0,27,21,10.0,6.72
1531,0.707,7,0,28,21,10.0,7.07
1532,0.766,6,0,28,22,10.0,7.66
1533,0.745,4,0,26,22,10.0,7.45
1534,0.636,7,0,27,20,10.0,6.36
1535,0.756,5,0,28,23,10.0,7.56
1536,0.77,5,0,26,21,10.0,7.7
1537,0.776,5,0,34,29,10.0,7.76
1538,0.732,7,0,25,18,10.0,7.32
1539,0.715,6,0,19,13,10.0,7.15
1540,0.645,9,0,29,20,10.0,6.45
1541,0.855,4,0,20,16,10.0,8.55
1542,0.592,9,0,29,20,10.0,5.92
1543,0.856,4,0,31,27,10.0,8.56
1544,0.848,4,0,30,26,10.0,8.48
1545,0.762,5,0,24,19,10.0,7.62
1546,0.75,7,0,31,24,10.0,7.5
1547,0.74,5,0,30,25,10.0,7.4
1548,0.645,9,0,33,24,10.0,6.45
1549,0.84,3,0,18,15,10.0,8.4
1550,0.64,5,0,19,14,10.0,6.4
1551,0.768,5,0,33,28,10.0,7.68
1552,0.728,7,0,30,23,10.0,7.28
1553,0.642,7,0,27,20,10.0,6.42
1554,0.786,5,0,24,19,10.0,7.86
1555,0.76,5,0,22,17,10.0,7.6
1556,0.643,10,0,28,18,10.0,6.43
1557,0.82,8,0,41,33,10.0,8.2
1558,0.712,6,0,26,20,10.0,7.12
1559,0.764,5,0,27,22,10.0,7.64
1560,0.768,7,0,36,29,10.0,7.68
1561,0.73,6,0,22,16,10.0,7.3
1562,0.716,5,0,31,26,10.0,7.16
1563,0.888,3,0,31,28,10.0,8.88
1564,0.72,6,0,29,23,10.0,7.2
1565,0.695,6,0,21,15,10.0,6.95
1566,0.784,6,0,23,17,10.0,7.84
1567,0.748,5,0,32,27,10.0,7.48
1568,0.825,3,0,26,23,10.0,8.25
1569,0.757,7,0,39,32,10.0,7.57
1570,0.76,5,0,22,17,10.0,7.6
1571,0.848,4,0,27,23,10.0,8.48
1572,0.728,6,0,21,15,10.0,7.28
1573,0.724,5,0,26,21,10.0,7.24
1574,0.776,4,0,30,26,10.0,7.76
1575,0.697,7,0,32,25,10.0,6.97
1576,0.886,4,0,32,28,10.0,8.86
1577,0.755,8,0,29,21,10.0,7.55
1578,0.781,6,0,23,17,10.0,7.81
1579,0.784,5,0,29,24,10.0,7.84
1580,0.768,5,0,31,26,10.0,7.68
1581,0.696,6,0,32,26,10.0,6.96
1582,0.742,7,0,32,25,10.0,7.42
1583,0.692,6,0,27,21,10.0,6.92
1584,0.856,4,0,28,24,10.0,8.56
1585,0.748,6,0,31,25,10.0,7.48
1586,0.772,6,0,29,23,10.0,7.72
1587,0.765,6,0,21,15,10.0,7.65
1588,0.83,5,0,36,31,10.0,8.3
1589,0.732,5,0,30,25,10.0,7.32
1590,0.766,6,0,28,22,10.0,7.66
1591,0.59,5,0,15,10,10.0,5.9
1592,0.76,5,0,20,15,10.0,7.6
1593,0.72,7,0,33,26,10.0,7.2
1594,0.67,6,0,17,11,10.0,6.7
1595,0.808,4,0,30,26,10.0,8.08
1596,0.825,3,0,19,16,10.0,8.25
1597,0.808,6,0,24,18,10.0,8.08
1598,0.733,8,0,33,25,10.0,7.33
1599,0.728,6,0,27,21,10.0,7.28
1600,0.707,8,0,26,18,10.0,7.07
1601,0.82,4,0,25,21,10.0,8.2
1602,0.724,7,0,30,23,10.0,7.24
1603,0.724,8,0,27,19,10.0,7.24
1604,0.739,6,0,23,17,10.0,7.39
1605,0.744,5,0,28,23,10.0,7.44
1606,0.668,7,0,25,18,10.0,6.68
1607,0.695,6,0,24,18,10.0,6.95
1608,0.875,3,0,18,15,10.0,8.75
1609,0.76,5,0,28,23,10.0,7.6
1610,0.72,5,0,22,17,10.0,7.2
1611,0.726,6,0,29,23,10.0,7.26
1612,0.765,4,0,19,15,10.0,7.65
1613,0.84,3,0,22,19,10.0,8.4
1614,0.808,4,0,18,14,10.0,8.08
1615,0.681,8,0,29,21,10.0,6.81
1616,0.768,5,0,28,23,10.0,7.68
1617,0.808,7,0,31,24,10.0,8.08
1618,0.84,3,0,21,18,10.0,8.4
1619,0.732,8,0,35,27,10.0,7.32
1620,0.714,7,0,29,22,10.0,7.14
1621,0.721,7,0,26,19,10.0,7.21
1622,0.736,6,0,33,27,10.0,7.36
1623,0.67,5,0,22,17,10.0,6.7
1624,0.8,4,0,21,17,10.0,8.0
1625,0.754,6,0,27,21,10.0,7.54
1626,0.741,6,0,35,29,10.0,7.41
1627,0.74,6,0,24,18,10.0,7.4
1628,0.771,8,0,38,30,10.0,7.71
1629,0.688,7,0,28,21,10.0,6.88
1630,0.756,6,0,31,25,10.0,7.56
1631,0.848,5,0,38,33,10.0,8.48
1632,0.644,7,0,31,24,10.0,6.44
1633,0.728,6,0,30,24,10.0,7.28
1634,0.74,5,0,21,16,10.0,7.4
1635,0.715,9,0,29,20,10.0,7.15
1636,0.745,7,0,37,30,10.0,7.45
1637,0.814,5,0,29,24,10.0,8.14
1638,0.664,6,0,27,21,10.0,6.64
1639,0.847,4,0,26,22,10.0,8.47
1640,0.756,8,0,32,24,10.0,7.56
1641,0.608,7,0,30,23,10.0,6.08
1642,0.794,6,0,35,29,10.0,7.94
1643,0.717,5,0,28,23,10.0,7.17
1644,0.786,5,0,32,27,10.0,7.86
1645,0.794,7,0,40,33,10.0,7.94
1646,0.655,6,0,24,18,10.0,6.55
1647,0.768,7,0,42,35,10.0,7.68
1648,0.7,6,0,28,22,10.0,7.0
1649,0.81,4,0,21,17,10.0,8.1
1650,0.792,5,0,22,17,10.0,7.92
1651,0.7,5,0,26,21,10.0,7.0
1652,0.82,8,0,46,38,10.0,8.2
1653,0.768,12,0,44,32,10.0,7.68
1654,0.848,6,0,28,22,10.0,8.48
1655,0.792,5,0,32,27,10.0,7.92
1656,0.8,3,0,19,16,10.0,8.0
1657,0.674,6,0,28,22,10.0,6.74
1658,0.896,5,0,35,30,10.0,8.96
1659,0.744,5,0,34,29,10.0,7.44
1660,0.792,6,0,34,28,10.0,7.92
1661,0.7,7,0,31,24,10.0,7.0
1662,0.635,5,0,23,18,10.0,6.35
1663,0.768,5,0,26,21,10.0,7.68
1664,0.86,3,0,20,17,10.0,8.6
1665,0.722,6,0,28,22,10.0,7.22
1666,0.76,4,0,28,24,10.0,7.6
1667,0.65,6,0,24,18,10.0,6.5
1668,0.736,5,0,28,23,10.0,7.36
1669,0.74,4,0,15,11,10.0,7.4
1670,0.65,4,0,18,14,10.0,6.5
1671,0.74,6,0,32,26,10.0,7.4
1672,0.765,4,0,20,16,10.0,7.65
1673,0.828,4,0,27,23,10.0,8.28
1674,0.799,5,0,32,27,10.0,7.99
1675,0.8,5,0,26,21,10.0,8.0
1676,0.848,4,0,29,25,10.0,8.48
1677,0.708,7,0,27,20,10.0,7.08
1678,0.704,6,0,34,28,10.0,7.04
1679,0.697,8,0,28,20,10.0,6.97
1680,0.76,4,0,19,15,10.0,7.6
1681,0.75,4,0,22,18,10.0,7.5
1682,0.702,9,0,30,21,10.0,7.02
1683,0.69,7,0,31,24,10.0,6.9
1684,0.9,2,0,16,14,10.0,9.0
1685,0.777,4,0,28,24,10.0,7.77
1686,0.795,3,0,17,14,10.0,7.95
1687,0.675,4,0,13,9,10.0,6.75
1688,0.792,4,0,24,20,10.0,7.92
1689,0.712,7,0,28,21,10.0,7.12
1690,0.692,7,0,28,21,10.0,6.92
1691,0.665,7,0,31,24,10.0,6.65
1692,0.776,5,0,27,22,10.0,7.76
1693,0.8,5,0,28,23,10.0,8.0
1694,0.85,5,0,31,26,10.0,8.5
1695,0.792,4,0,27,23,10.0,7.92
1696,0.808,5,0,34,29,10.0,8.08
1697,0.8,4,0,19,15,10.0,8.0
1698,0.694,6,0,27,21,10.0,6.94
1699,0.64,5,0,27,22,10.0,6.4
1700,0.69,6,0,25,19,10.0,6.9
1701,0.84,3,0,29,26,10.0,8.4
1702,0.777,7,0,27,20,10.0,7.77
1703,0.738,7,0,29,22,10.0,7.38
1704,0.78,4,0,20,16,10.0,7.8
1705,0.604,7,0,24,17,10.0,6.04
1706,0.78,4,0,17,13,10.0,7.8
1707,0.808,4,0,26,22,10.0,8.08
1708,0.698,10,0,33,23,10.0,6.98
1709,0.628,9,0,28,19,10.0,6.28
1710,0.768,6,0,32,26,10.0,7.68
1711,0.786,5,0,22,17,10.0,7.86
1712,0.745,6,0,22,16,10.0,7.45
1713,0.696,7,0,30,23,10.0,6.96
1714,0.732,8,0,37,29,10.0,7.32
1715,0.692,7,0,37,30,10.0,6.92
1716,0.829,5,0,26,21,10.0,8.29
1717,0.8,8,0,39,31,10.0,8.0
1718,0.675,6,0,19,13,10.0,6.75
1719,0.76,4,0,29,25,10.0,7.6
1720,0.759,8,0,39,31,10.0,7.59
1721,0.648,7,0,32,25,10.0,6.48
1722,0.7,6,0,25,19,10.0,7.0
1723,0.765,4,0,18,14,10.0,7.65
1724,0.603,9,0,29,20,10.0,6.03
1725,0.72,5,0,20,15,10.0,7.2
1726,0.69,6,0,20,14,10.0,6.9
1727,0.9,2,0,22,20,10.0,9.0
1728,0.624,8,0,27,19,10.0,6.24
1729,0.788,5,0,28,23,10.0,7.88
1730,0.708,7,0,29,22,10.0,7.08
1731,0.772,6,0,30,24,10.0,7.72
1732,0.664,7,0,28,21,10.0,6.64
1733,0.728,6,0,32,26,10.0,7.28
1734,0.72,5,0,27,22,10.0,7.2
1735,0.808,5,0,29,24,10.0,8.08
1736,0.814,8,0,47,39,10.0,8.14
1737,0.795,4,0,28,24,10.0,7.95
1738,0.79,5,0,22,17,10.0,7.9
1739,0.788,5,0,32,27,10.0,7.88
1740,0.66,8,0,30,22,10.0,6.6
1741,0.75,4,0,24,20,10.0,7.5
1742,0.782,5,0,26,21,10.0,7.82
1743,0.776,4,0,23,19,10.0,7.76
1744,0.62,8,0,29,21,10.0,6.2
1745,0.672,7,0,27,20,10.0,6.72
1746,0.774,6,0,31,25,10.0,7.74
1747,0.798,7,0,37,30,10.0,7.98
1748,0.748,5,0,30,25,10.0,7.48
1749,0.74,6,0,28,22,10.0,7.4
1750,0.57,10,0,29,19,10.0,5.7
1751,0.801,4,0,27,23,10.0,8.01
1752,0.564,9,0,25,16,10.0,5.64
1753,0.732,8,0,39,31,10.0,7.32
1754,0.748,6,0,28,22,10.0,7.48
1755,0.6,10,0,29,19,10.0,6.0
1756,0.725,5,0,24,19,10.0,7.25
1757,0.82,4,0,20,16,10.0,8.2
1758,0.768,5,0,31,26,10.0,7.68
1759,0.826,9,0,42,33,10.0,8.26
1760,0.734,6,0,31,25,10.0,7.34
1761,0.74,10,0,40,30,10.0,7.4
1762,0.761,5,0,31,26,10.0,7.61
1763,0.848,4,0,21,17,10.0,8.48
1764,0.744,5,0,28,23,10.0,7.44
1765,0.82,4,0,19,15,10.0,8.2
1766,0.764,6,0,31,25,10.0,7.64
1767,0.784,6,0,33,27,10.0,7.84
1768,0.74,4,0,19,15,10.0,7.4
1769,0.68,7,0,27,20,10.0,6.8
1770,0.74,4,0,20,16,10.0,7.4
1771,0.7,9,0,29,20,10.0,7.0
1772,0.771,5,0,28,23,10.0,7.71
1773,0.767,5,0,27,22,10.0,7.67
1774,0.845,5,0,24,19,10.0,8.45
1775,0.724,6,0,28,22,10.0,7.24
1776,0.716,5,0,26,21,10.0,7.16
1777,0.66,6,0,29,23,10.0,6.6
1778,0.729,5,0,25,20,10.0,7.29
1779,0.784,5,0,21,16,10.0,7.84
1780,0.804,5,0,32,27,10.0,8.04
1781,0.8,3,0,21,18,10.0,8.0
1782,0.82,5,0,26,21,10.0,8.2
1783,0.619,10,0,31,21,10.0,6.19
1784,0.715,6,0,30,24,10.0,7.15
1785,0.728,5,0,27,22,10.0,7.28
1786,0.64,6,0,24,18,10.0,6.4
1787,0.85,3,0,16,13,10.0,8.5
1788,0.82,4,0,21,17,10.0,8.2
1789,0.708,7,0,36,29,10.0,7.08
1790,0.894,4,0,28,24,10.0,8.94
1791,0.652,8,0,28,20,10.0,6.52
1792,0.76,4,0,25,21,10.0,7.6
1793,0.84,3,0,26,23,10.0,8.4
1794,0.7,6,0,29,23,10.0,7.0
1795,0.681,6,0,25,19,10.0,6.81
1796,0.86,4,0,26,22,10.0,8.6
1797,0.615,7,0,25,18,10.0,6.15
1798,0.784,9,0,40,31,10.0,7.84
1799,0.667,8,0,27,19,10.0,6.67
1800,0.73,6,0,33,27,10.0,7.3
1801,0.73,7,0,27,20,10.0,7.3
1802,0.708,7,0,23,16,10.0,7.08
1803,0.772,7,0,28,21,10.0,7.72
1804,0.685,5,0,20,15,10.0,6.85
1805,0.814,5,0,31,26,10.0,8.14
1806,0.728,7,0,35,28,10.0,7.28
1807,0.726,8,0,32,24,10.0,7.26
1808,0.645,8,0,26,18,10.0,6.45
1809,0.788,7,0,33,26,10.0,7.88
1810,0.78,6,0,26,20,10.0,7.8
1811,0.71,10,0,32,22,10.0,7.1
1812,0.731,6,0,29,23,10.0,7.31
1813,0.674,7,0,31,24,10.0,6.74
1814,0.868,5,0,40,35,10.0,8.68
1815,0.846,8,0,33,25,10.0,8.46
1816,0.78,4,0,21,17,10.0,7.8
1817,0.703,8,0,28,20,10.0,7.03
1818,0.812,6,0,25,19,10.0,8.12
1819,0.7,4,0,20,16,10.0,7.0
1820,0.817,5,0,26,21,10.0,8.17
1821,0.81,4,0,23,19,10.0,8.1
1822,0.806,4,0,31,27,10.0,8.06
1823,0.766,6,0,30,24,10.0,7.66
1824,0.85,5,0,42,37,10.0,8.5
1825,0.776,7,0,41,34,10.0,7.76
1826,0.705,5,0,22,17,10.0,7.05
1827,0.7,4,0,27,23,10.0,7.0
1828,0.701,6,0,31,25,10.0,7.01
1829,0.812,4,0,30,26,10.0,8.12
1830,0.768,6,0,39,33,10.0,7.68
1831,0.752,5,0,26,21,10.0,7.52
1832,0.759,6,0,30,24,10.0,7.59
1833,0.696,6,0,27,21,10.0,6.96
1834,0.808,4,0,29,25,10.0,8.08
1835,0.86,3,0,19,16,10.0,8.6
1836,0.64,6,0,19,13,10.0,6.4
1837,0.72,7,0,28,21,10.0,7.2
1838,0.6,10,0,28,18,10.0,6.0
1839,0.703,7,0,29,22,10.0,7.03
1840,0.72,5,0,22,17,10.0,7.2
1841,0.82,5,0,33,28,10.0,8.2
1842,0.764,7,0,39,32,10.0,7.64
1843,0.8,3,0,20,17,10.0,8.0
1844,0.617,9,0,26,17,10.0,6.17
1845,0.745,5,0,29,24,10.0,7.45
1846,0.716,6,0,29,23,10.0,7.16
1847,0.68,6,0,30,24,10.0,6.8
1848,0.788,5,0,35,30,10.0,7.88
1849,0.724,6,0,26,20,10.0,7.24
1850,0.732,7,0,26,19,10.0,7.32
1851,0.818,5,0,31,26,10.0,8.18
1852,0.728,6,0,31,25,10.0,7.28
1853,0.876,4,0,25,21,10.0,8.76
1854,0.768,5,0,38,33,10.0,7.68
1855,0.764,5,0,34,29,10.0,7.64
1856,0.805,4,0,24,20,10.0,8.05
1857,0.648,7,0,26,19,10.0,6.48
1858,0.682,8,0,29,21,10.0,6.82
1859,0.84,4,0,30,26,10.0,8.4
1860,0.8,7,0,25,18,10.0,8.0
1861,0.705,5,0,18,13,10.0,7.05
1862,0.9,2,0,22,20,10.0,9.0
1863,0.844,6,0,30,24,10.0,8.44
1864,0.61,7,0,22,15,10.0,6.1
1865,0.688,6,0,24,18,10.0,6.88
1866,0.62,6,0,28,22,10.0,6.2
1867,0.71,6,0,22,16,10.0,7.1
1868,0.75,3,0,13,10,10.0,7.5
1869,0.725,5,0,28,23,10.0,7.25
1870,0.784,6,0,27,21,10.0,7.84
1871,0.748,7,0,28,21,10.0,7.48
1872,0.564,9,0,27,18,10.0,5.64
1873,0.9,2,0,19,17,10.0,9.0
1874,0.744,7,0,30,23,10.0,7.44
1875,0.58,6,0,18,12,10.0,5.8
1876,0.8,4,0,26,22,10.0,8.0
1877,0.714,5,0,31,26,10.0,7.14
1878,0.752,4,0,27,23,10.0,7.52
1879,0.583,8,0,25,17,10.0,5.83
1880,0.816,4,0,26,22,10.0,8.16
1881,0.781,5,0,28,23,10.0,7.81
1882,0.732,7,0,29,22,10.0,7.32
1883,0.714,8,0,30,22,10.0,7.14
1884,0.757,5,0,21,16,10.0,7.57
1885,0.785,5,0,29,24,10.0,7.85
1886,0.663,7,0,25,18,10.0,6.63
1887,0.729,6,0,31,25,10.0,7.29
1888,0.675,5,0,24,19,10.0,6.75
1889,0.721,7,0,25,18,10.0,7.21
1890,0.76,6,0,36,30,10.0,7.6
1891,0.677,7,0,22,15,10.0,6.77
1892,0.724,8,0,36,28,10.0,7.24
1893,0.68,8,0,28,20,10.0,6.8
1894,0.74,7,0,27,20,10.0,7.4
1895,0.756,6,0,32,26,10.0,7.56
1896,0.848,4,0,26,22,10.0,8.48
1897,0.636,10,0,27,17,10.0,6.36
1898,0.742,7,0,26,19,10.0,7.42
1899,0.808,4,0,32,28,10.0,8.08
1900,0.804,4,0,31,27,10.0,8.04
1901,0.84,3,0,25,22,10.0,8.4
1902,0.78,4,0,26,22,10.0,7.8
1903,0.93,3,0,23,20,10.0,9.3
1904,0.752,6,0,28,22,10.0,7.52
1905,0.776,5,0,29,24,10.0,7.76
1906,0.816,5,0,27,22,10.0,8.16
1907,0.675,4,0,22,18,10.0,6.75
1908,0.665,8,0,28,20,10.0,6.65
1909,0.714,8,0,27,19,10.0,7.14
1910,0.832,7,0,36,29,10.0,8.32
1911,0.756,7,0,34,27,10.0,7.56
1912,0.694,7,0,24,17,10.0,6.94
1913,0.718,8,0,27,19,10.0,7.18
1914,0.775,4,0,18,14,10.0,7.75
1915,0.675,6,0,23,17,10.0,6.75
1916,0.728,5,0,27,22,10.0,7.28
1917,0.689,7,0,26,19,10.0,6.89
1918,0.76,4,0,31,27,10.0,7.6
1919,0.705,5,0,16,11,10.0,7.05
1920,0.72,5,0,22,17,10.0,7.2
1921,0.696,6,0,31,25,10.0,6.96
1922,0.832,5,0,28,23,10.0,8.32
1923,0.768,6,0,26,20,10.0,7.68
1924,0.783,7,0,39,32,10.0,7.83
1925,0.802,6,0,41,35,10.0,8.02
1926,0.704,9,0,33,24,10.0,7.04
1927,0.632,7,0,26,19,10.0,6.32
1928,0.76,6,0,29,23,10.0,7.6
1929,0.829,4,0,22,18,10.0,8.29
1930,0.9,2,0,11,9,10.0,9.0
1931,0.775,3,0,18,15,10.0,7.75
1932,0.76,7,0,24,17,10.0,7.6
1933,0.769,6,0,31,25,10.0,7.69
1934,0.7,5,0,22,17,10.0,7.0
1935,0.683,7,0,31,24,10.0,6.83
1936,0.82,5,0,30,25,10.0,8.2
1937,0.792,5,0,26,21,10.0,7.92
1938,0.731,6,0,30,24,10.0,7.31
1939,0.804,5,0,28,23,10.0,8.04
1940,0.75,3,0,12,9,10.0,7.5
1941,0.636,7,0,29,22,10.0,6.36
1942,0.695,5,0,23,18,10.0,6.95
1943,0.86,3,0,32,29,10.0,8.6
1944,0.8,3,0,16,13,10.0,8.0
1945,0.69,6,0,23,17,10.0,6.9
1946,0.816,5,0,39,34,10.0,8.16
1947,0.62,7,0,31,24,10.0,6.2
1948,0.67,5,0,20,15,10.0,6.7
1949,0.783,5,0,26,21,10.0,7.83
1950,0.692,8,0,28,20,10.0,6.92
1951,0.772,8,0,36,28,10.0,7.72
1952,0.86,3,0,25,22,10.0,8.6
1953,0.75,5,0,25,20,10.0,7.5
1954,0.686,12,0,37,25,10.0,6.86
1955,0.8,3,0,23,20,10.0,8.0
1956,0.844,4,0,29,25,10.0,8.44
1957,0.827,4,0,25,21,10.0,8.27
1958,0.725,5,0,26,21,10.0,7.25
1959,0.854,4,0,29,25,10.0,8.54
1960,0.765,4,0,22,18,10.0,7.65
1961,0.88,4,0,30,26,10.0,8.8
1962,0.888,4,0,42,38,10.0,8.88
1963,0.76,6,0,30,24,10.0,7.6
1964,0.762,7,0,29,22,10.0,7.62
1965,0.856,4,0,30,26,10.0,8.56
1966,0.713,6,0,29,23,10.0,7.13
1967,0.712,6,0,29,23,10.0,7.12
1968,0.75,9,0,48,39,10.0,7.5
1969,0.733,7,0,26,19,10.0,7.33
1970,0.864,4,0,26,22,10.0,8.64
1971,0.704,6,0,29,23,10.0,7.04
1972,0.77,4,0,15,11,10.0,7.7
1973,0.795,4,0,19,15,10.0,7.95
1974,0.76,5,0,29,24,10.0,7.6
1975,0.755,4,0,21,17,10.0,7.55
1976,0.555,8,0,25,17,10.0,5.55
1977,0.755,4,0,17,13,10.0,7.55
1978,0.792,4,0,27,23,10.0,7.92
1979,0.796,5,0,30,25,10.0,7.96
1980,0.74,9,0,30,21,10.0,7.4
1981,0.768,6,0,37,31,10.0,7.68
1982,0.82,4,0,21,17,10.0,8.2
1983,0.821,9,0,35,26,10.0,8.21
1984,0.8,5,0,32,27,10.0,8.0
1985,0.815,4,0,24,20,10.0,8.15
1986,0.76,5,0,20,15,10.0,7.6
1987,0.843,5,0,30,25,10.0,8.43
1988,0.825,3,0,23,20,10.0,8.25
1989,0.7,6,0,27,21,10.0,7.0
1990,0.86,3,0,20,17,10.0,8.6
1991,0.697,7,0,29,22,10.0,6.97
1992,0.711,6,0,27,21,10.0,7.11
1993,0.736,4,0,26,22,10.0,7.36
1994,0.664,6,0,26,20,10.0,6.64
1995,0.731,5,0,23,18,10.0,7.31
1996,0.737,7,0,25,18,10.0,7.37
1997,0.7,7,0,27,20,10.0,7.0
1998,0.846,5,0,30,25,10.0,8.46
1999,0.652,6,0,31,25,10.0,6.52
2000,0.764,5,0,34,29,10.0,7.64
2001,0.855,3,0,18,15,10.0,8.55
2002,0.808,5,0,30,25,10.0,8.08
2003,0.78,4,0,23,19,10.0,7.8
2004,0.76,6,0,28,22,10.0,7.6
2005,0.744,5,0,30,25,10.0,7.44
2006,0.64,6,0,20,14,10.0,6.4
2007,0.645,7,0,28,21,10.0,6.45
2008,0.768,6,0,35,29,10.0,7.68
2009,0.75,6,0,40,34,10.0,7.5
2010,0.8,4,0,27,23,10.0,8.0
2011,0.672,8,0,33,25,10.0,6.72
2012,0.756,7,0,25,18,10.0,7.56
2013,0.749,5,0,30,25,10.0,7.49
2014,0.773,6,0,32,26,10.0,7.73
2015,0.665,6,0,15,9,10.0,6.65
2016,0.792,4,0,28,24,10.0,7.92
2017,0.74,5,0,35,30,10.0,7.4
2018,0.756,5,0,27,22,10.0,7.56
2019,0.644,9,0,27,18,10.0,6.44
2020,0.79,4,0,25,21,10.0,7.9
2021,0.8,5,0,35,30,10.0,8.0
2022,0.8,3,0,18,15,10.0,8.0
2023,0.816,5,0,36,31,10.0,8.16
2024,0.652,8,0,24,16,10.0,6.52
2025,0.756,5,0,26,21,10.0,7.56
2026,0.692,6,0,25,19,10.0,6.92
2027,0.76,5,0,28,23,10.0,7.6
2028,0.742,6,0,22,16,10.0,7.42
2029,0.624,7,0,29,22,10.0,6.24
2030,0.655,8,0,37,29,10.0,6.55
2031,0.8,4,0,36,32,10.0,8.0
2032,0.704,5,0,32,27,10.0,7.04
2033,0.844,4,0,32,28,10.0,8.44
2034,0.74,4,0,19,15,10.0,7.4
2035,0.815,3,0,22,19,10.0,8.15
2036,0.74,6,0,28,22,10.0,7.4
2037,0.636,7,0,25,18,10.0,6.36
2038,0.65,5,0,22,17,10.0,6.5
2039,0.54,7,0,27,20,10.0,5.4
2040,0.72,5,0,22,17,10.0,7.2
2041,0.653,6,0,27,21,10.0,6.53
2042,0.82,7,0,40,33,10.0,8.2
2043,0.8,4,0,28,24,10.0,8.0
2044,0.727,9,0,42,33,10.0,7.27
2045,0.744,5,0,26,21,10.0,7.44
2046,0.658,7,0,27,20,10.0,6.58
2047,0.559,7,0,25,18,10.0,5.59
2048,0.754,10,0,32,22,10.0,7.54
2049,0.748,6,0,31,25,10.0,7.48
2050,0.771,8,0,30,22,10.0,7.71
2051,0.816,7,0,29,22,10.0,8.16
2052,0.8,5,0,33,28,10.0,8.0
2053,0.81,5,0,29,24,10.0,8.1
2054,0.72,8,0,33,25,10.0,7.2
2055,0.865,3,0,26,23,10.0,8.65
2056,0.696,6,0,26,20,10.0,6.96
2057,0.712,6,0,34,28,10.0,7.12
2058,0.74,5,0,26,21,10.0,7.4
2059,0.755,5,0,29,24,10.0,7.55
2060,0.74,6,0,29,23,10.0,7.4
2061,0.69,4,0,15,11,10.0,6.9
2062,0.7,5,0,29,24,10.0,7.0
2063,0.739,6,0,28,22,10.0,7.39
2064,0.764,7,0,35,28,10.0,7.64
2065,0.725,5,0,17,12,10.0,7.25
2066,0.704,7,0,28,21,10.0,7.04
2067,0.696,7,0,30,23,10.0,6.96
2068,0.71,6,0,31,25,10.0,7.1
2069,0.76,5,0,28,23,10.0,7.6
2070,0.78,4,0,19,15,10.0,7.8
2071,0.8,5,0,31,26,10.0,8.0
2072,0.749,5,0,28,23,10.0,7.49
2073,0.773,7,0,31,24,10.0,7.73
2074,0.714,5,0,26,21,10.0,7.14
2075,0.672,7,0,28,21,10.0,6.72
2076,0.724,5,0,31,26,10.0,7.24
2077,0.752,6,0,27,21,10.0,7.52
2078,0.748,6,0,36,30,10.0,7.48
2079,0.72,5,0,23,18,10.0,7.2
2080,0.74,4,0,24,20,10.0,7.4
2081,0.615,8,0,27,19,10.0,6.15
2082,0.78,4,0,20,16,10.0,7.8
2083,0.77,4,0,32,28,10.0,7.7
2084,0.78,4,0,17,13,10.0,7.8
2085,0.78,4,0,18,14,10.0,7.8
2086,0.875,2,0,18,16,10.0,8.75
2087,0.704,6,0,31,25,10.0,7.04
2088,0.788,4,0,28,24,10.0,7.88
2089,0.802,5,0,30,25,10.0,8.02
2090,0.73,8,0,36,28,10.0,7.3
2091,0.675,8,0,25,17,10.0,6.75
2092,0.758,7,0,30,23,10.0,7.58
2093,0.815,5,0,36,31,10.0,8.15
2094,0.783,5,0,26,21,10.0,7.83
2095,0.782,8,0,41,33,10.0,7.82
2096,0.684,7,0,31,24,10.0,6.84
2097,0.794,6,0,37,31,10.0,7.94
2098,0.7,6,0,25,19,10.0,7.0
2099,0.76,4,0,19,15,10.0,7.6
2100,0.776,5,0,26,21,10.0,7.76
